OF60RR	VOIMASSA	
OF9X	VOIMASSA	
OG0C	VOIMASSA	
OG0D	VOIMASSA	
OG0J	VOIMASSA	
OG0M	VOIMASSA	
OG0N	VOIMASSA	
OG0R	VOIMASSA	
OG0W	VOIMASSA	
OG0YL	VOIMASSA	
OG16M	VOIMASSA	
OG1A	VOIMASSA	
OG1AO	VOIMASSA	
OG1C	VOIMASSA	
OG1D	VOIMASSA	
OG1E	VOIMASSA	
OG1J	VOIMASSA	
OG1MAX	VOIMASSA	
OG1N	VOIMASSA	
OG1SDR	VOIMASSA	
OG1W	VOIMASSA	
OG1VAN	VOIMASSA	
OG1X	VOIMASSA	
OG1XMAS	VOIMASSA	
OG2A	VOIMASSA	
OG2B	VOIMASSA	
OG2C	VOIMASSA	
OG2E	VOIMASSA	
OG2F	VOIMASSA	
OG2G	VOIMASSA	
OG2GO	VOIMASSA	
OG2J	VOIMASSA	
OG2K	VOIMASSA	
OG2M	VOIMASSA	
OG2N	VOIMASSA	
OG2P	VOIMASSA	
OG2R	VOIMASSA	
OG2T	VOIMASSA	
OG2V	VOIMASSA	
OG2W	VOIMASSA	
OG2X	VOIMASSA	
OG30OM	VOIMASSA	
OG30YL	VOIMASSA	
OG3A	VOIMASSA	
OG3AAA	VOIMASSA	
OG3B	VOIMASSA	
OG3C	VOIMASSA	
OG3FI	VOIMASSA	
OG3G	VOIMASSA	
OG3M	VOIMASSA	
OG3MS	VOIMASSA	
OG3P	VOIMASSA	
OG3W	VOIMASSA	
OG3X	VOIMASSA	
OG3Z	VOIMASSA	
OG4A	VOIMASSA	
OG4M	VOIMASSA	
OG4R	VOIMASSA	
OG4T	VOIMASSA	
OG4U	VOIMASSA	
OG4W	VOIMASSA	
OG4X	VOIMASSA	
OG4Z	VOIMASSA	
OG55W	VOIMASSA	
OG5A	VOIMASSA	
OG5G	VOIMASSA	
OG5N	VOIMASSA	
OG5O	VOIMASSA	
OG5R	VOIMASSA	
OG5T	VOIMASSA	
OG5W	VOIMASSA	
OG5Z	VOIMASSA	
OG60IPA	VOIMASSA	
OG66X	VOIMASSA	
OG6A	VOIMASSA	
OG6G	VOIMASSA	
OG6I	VOIMASSA	
OG6K	VOIMASSA	
OG6M	VOIMASSA	
OG6MOK	VOIMASSA	
OG6N	VOIMASSA	
OG6O	VOIMASSA	
OG6S	VOIMASSA	
OG6T	VOIMASSA	
OG6W	VOIMASSA	
OG6X	VOIMASSA	
OG6Z	VOIMASSA	
OG70AD	VOIMASSA	
OG73WR 	VOIMASSA	
OG73X	VOIMASSA	
OG7A	VOIMASSA	
OG7D	VOIMASSA	
OG7F	VOIMASSA	
OG7G	VOIMASSA	
OG7GO	VOIMASSA	
OG7J	VOIMASSA	
OG7KA	VOIMASSA	
OG7M	VOIMASSA	
OG7X	VOIMASSA	
OG7Z	VOIMASSA	
OG8A	VOIMASSA	
OG8C	VOIMASSA	
OG8L	VOIMASSA	
OG8O	VOIMASSA	
OG8T	VOIMASSA	
OG8X	VOIMASSA	
OG95AA	VOIMASSA	
OG9A	VOIMASSA	
OG9R	VOIMASSA	
OG9W	VOIMASSA	
OH*AAP	KARENSSI	
OH*AAS	KARENSSI	
OH*AYW	KARENSSI	
OH*BAA	KARENSSI	
OH*BAB	KARENSSI	
OH*BAO	KARENSSI	
OH*BBN	KARENSSI	
OH*BBR	KARENSSI	
OH*BCA	KARENSSI	
OH*BCF	KARENSSI	
OH*BCN	KARENSSI	
OH*BCU	KARENSSI	
OH*BDM	KARENSSI	
OH*BDY	KARENSSI	
OH*BED	KARENSSI	
OH*BEM	KARENSSI	
OH*BEQ	KARENSSI	
OH*BFT	KARENSSI	
OH*BHQ	KARENSSI	
OH*BII	KARENSSI	
OH*BKB	KARENSSI	
OH*BKD	KARENSSI	
OH*BKM	KARENSSI	
OH*BLA	KARENSSI	
OH*BNR	KARENSSI	
OH*BNY	KARENSSI	
OH*BOB	KARENSSI	
OH*BOV	KARENSSI	
OH*BPQ	KARENSSI	
OH*BQJ	KARENSSI	
OH*BQT	KARENSSI	
OH*BRS	KARENSSI	
OH*BRV	KARENSSI	
OH*BRW	KARENSSI	
OH*BUO	KARENSSI	
OH*BVO	KARENSSI	
OH*BVR	KARENSSI	
OH*BYM	KARENSSI	
OH*BZL	KARENSSI	
OH*CEP	KARENSSI	
OH*CEV	KARENSSI	
OH*CEY	KARENSSI	
OH*ECI	KARENSSI	
OH*ECZ	KARENSSI	
OH*EDG	KARENSSI	
OH*EEQ	KARENSSI	
OH*EHB	KARENSSI	
OH*EHP	KARENSSI	
OH*EJY	KARENSSI	
OH*ELW	KARENSSI	
OH*EOJ	KARENSSI	
OH*EQI	KARENSSI	
OH*EQP	KARENSSI	
OH*ERE	KARENSSI	
OH*ERL	KARENSSI	
OH*ESL	KARENSSI	
OH*ESQ	KARENSSI	
OH*ESY	KARENSSI	
OH*ESZ	KARENSSI	
OH*ETA	KARENSSI	
OH*ETK	KARENSSI	
OH*ETU	KARENSSI	
OH*EUK	KARENSSI	
OH*EUW	KARENSSI	
OH*EVB	KARENSSI	
OH*EVD	KARENSSI	
OH*EWF	KARENSSI	
OH*EWM	KARENSSI	
OH*EVV	KARENSSI	
OH*EXV	KARENSSI	
OH*EYA	KARENSSI	
OH*EZS	KARENSSI	
OH*EZY	KARENSSI	
OH*FAD	KARENSSI	
OH*FBO	KARENSSI	
OH*FCF	KARENSSI	
OH*FCN	KARENSSI	
OH*FCW	KARENSSI	
OH*FDO	KARENSSI	
OH*FDT	KARENSSI	
OH*FFY	KARENSSI	
OH*FGG	KARENSSI	
OH*FGO	KARENSSI	
OH*FHK	KARENSSI	
OH*FJH	KARENSSI	
OH*FJK	KARENSSI	
OH*FJX	KARENSSI	
OH*FOI	KARENSSI	
OH*FPC	KARENSSI	
OH*FPX	KARENSSI	
OH*FQO	KARENSSI	
OH*FRT	KARENSSI	
OH*FSM	KARENSSI	
OH*FVT	KARENSSI	
OH*FZE	KARENSSI	
OH*GAC	KARENSSI	
OH*GFP	KARENSSI	
OH*GJE	KARENSSI	
OH*GJP	KARENSSI	
OH*GKF	KARENSSI	
OH*GKL	KARENSSI	
OH*GNF	KARENSSI	
OH*GQA	KARENSSI	
OH*GQJ	KARENSSI	
OH*GRG	KARENSSI	
OH*GTU	KARENSSI	
OH*GVP	KARENSSI	
OH*GYQ	KARENSSI	
OH*GZN	KARENSSI	
OH*HBX	KARENSSI	
OH*HDK	KARENSSI	
OH*HFD	KARENSSI	
OH*HGP	KARENSSI	
OH*HHB	KARENSSI	
OH*HII	KARENSSI	
OH*HIQ	KARENSSI	
OH*HMA	KARENSSI	
OH*HRC	KARENSSI	
OH*HRQ	KARENSSI	
OH*HSR	KARENSSI	
OH*HTQ	KARENSSI	
OH*HWG	KARENSSI	
OH*HVK	KARENSSI	
OH*HXB	KARENSSI	
OH*HYU	KARENSSI	
OH*HZE	KARENSSI	
OH*HZF	KARENSSI	
OH*HZJ	KARENSSI	
OH*HZY	KARENSSI	
OH*JAG	KARENSSI	
OH*JCQ	KARENSSI	
OH*JDO	KARENSSI	
OH*JFO	KARENSSI	
OH*JHI	KARENSSI	
OH*JHU	KARENSSI	
OH*JIS	KARENSSI	
OH*JJI	KARENSSI	
OH*JLG	KARENSSI	
OH*JPO	KARENSSI	
OH*JQX	KARENSSI	
OH*JRO	KARENSSI	
OH*JTH	KARENSSI	
OH*JUL	KARENSSI	
OH*JUX	KARENSSI	
OH*JVE	KARENSSI	
OH*JVM	KARENSSI	
OH*JXQ	KARENSSI	
OH*KBE	KARENSSI	
OH*KBQ	KARENSSI	
OH*KET	KARENSSI	
OH*KEX	KARENSSI	
OH*KGT	KARENSSI	
OH*KLM	KARENSSI	
OH*KOP	KARENSSI	
OH*KWE	KARENSSI	
OH*KXH	KARENSSI	
OH*KYS	KARENSSI	
OH*LCY	KARENSSI	
OH*LDY	KARENSSI	
OH*LFL	KARENSSI	
OH*LGI	KARENSSI	
OH*LIZ	KARENSSI	
OH*LJL	KARENSSI	
OH*LJR	KARENSSI	
OH*LMO	KARENSSI	
OH*LNO	KARENSSI	
OH*LPM	KARENSSI	
OH*LPX	KARENSSI	
OH*LRC	KARENSSI	
OH*LSH	KARENSSI	
OH*LVC	KARENSSI	
OH*LWD	KARENSSI	
OH*LWM	KARENSSI	
OH*LXR	KARENSSI	
OH*MBO	KARENSSI	
OH*MBY	KARENSSI	
OH*MCS	KARENSSI	
OH*MDC	KARENSSI	
OH*MDT	KARENSSI	
OH*MFZ	KARENSSI	
OH*MHT	KARENSSI	
OH*MKN	KARENSSI	
OH*MPH	KARENSSI	
OH*MPM	KARENSSI	
OH*MQS	KARENSSI	
OH*MSM	KARENSSI	
OH*MTC	KARENSSI	
OH*MVT	KARENSSI	
OH*MWX	KARENSSI	
OH*MYS	KARENSSI	
OH*NAK	KARENSSI	
OH*NBT	KARENSSI	
OH*NDZ	KARENSSI	
OH*NEF	KARENSSI	
OH*NEJ	KARENSSI	
OH*NFE	KARENSSI	
OH*NGB	KARENSSI	
OH*NGW	KARENSSI	
OH*NJV	KARENSSI	
OH*NLY	KARENSSI	
OH*NMK	KARENSSI	
OH*NPF	KARENSSI	
OH*NST	KARENSSI	
OH*NWO	KARENSSI	
OH*NVZ	KARENSSI	
OH*NYK	KARENSSI	
OH*NYY	KARENSSI	
OH*RDJ	KARENSSI	
OH*UAU	KARENSSI	
OH*UBD	KARENSSI	
OH*UBU	KARENSSI	
OH*UBZ	KARENSSI	
OH*UCF	KARENSSI	
OH*UCL	KARENSSI	
OH*UDK	KARENSSI	
OH*UDR	KARENSSI	
OH0A	VOIMASSA	
OH0AA	VOIMASSA	
OH0AL	KARENSSI	
OH0AM	VOIMASSA	
OH0AP	VOIMASSA	
OH0AW	VOIMASSA	
OH0AZ	VOIMASSA	
OH0AZX	VOIMASSA	
OH0AZY	VOIMASSA	
OH0B	VOIMASSA	
OH0BA	VOIMASSA	
OH0BCI	VOIMASSA	
OH0BCW	VOIMASSA	
OH0BE	VOIMASSA	
OH0BH	VOIMASSA	
OH0BHU	VOIMASSA	
OH0BOI	VOIMASSA	
OH0BP	VOIMASSA	
OH0BR	VOIMASSA	
OH0BS	VOIMASSA	
OH0BU	VOIMASSA	
OH0BVI	VOIMASSA	
OH0C	VOIMASSA	
OH0CB	VOIMASSA	
OH0CD	VOIMASSA	
OH0CO	VOIMASSA	
OH0CW	VOIMASSA	
OH0DX	VOIMASSA	
OH0E	VOIMASSA	
OH0EA	VOIMASSA	
OH0EC	KARENSSI	
OH0EG	VOIMASSA	
OH0ELFA	VOIMASSA	
OH0EP	VOIMASSA	
OH0ES	VOIMASSA	
OH0EYO	VOIMASSA	
OH0FM	VOIMASSA	
OH0G	VOIMASSA	
OH0GG	VOIMASSA	
OH0GHK	VOIMASSA	
OH0GHL	VOIMASSA	
OH0GHN	VOIMASSA	
OH0GHU	VOIMASSA	
OH0GLO	VOIMASSA	
OH0GLQ	VOIMASSA	
OH0HEH	VOIMASSA	
OH0HG	KARENSSI	
OH0HQ	VOIMASSA	
OH0II	VOIMASSA	
OH0J	VOIMASSA	
OH0JAD	VOIMASSA	
OH0JAM	VOIMASSA	
OH0JET	VOIMASSA	
OH0JFB	VOIMASSA	
OH0JFV	VOIMASSA	
OH0JGY	VOIMASSA	
OH0JIA	VOIMASSA	
OH0JJB	VOIMASSA	
OH0JJN	VOIMASSA	
OH0JJS	VOIMASSA	
OH0JKA	VOIMASSA	
OH0JKB	VOIMASSA	
OH0JLQ	VOIMASSA	
OH0JLR	VOIMASSA	
OH0JN	VOIMASSA	
OH0JOK	VOIMASSA	
OH0JOM	VOIMASSA	
OH0JOX	VOIMASSA	
OH0JP	VOIMASSA	
OH0JTU	VOIMASSA	
OH0JV	VOIMASSA	
OH0JWL	VOIMASSA	
OH0K	VOIMASSA	
OH0KA	VOIMASSA	
OH0KAG	VOIMASSA	
OH0KCE	VOIMASSA	
OH0KI	VOIMASSA	
OH0KLG	VOIMASSA	
OH0KM	VOIMASSA	
OH0KNB	VOIMASSA	
OH0KRT	VOIMASSA	
OH0KSA	VOIMASSA	
OH0KXE	VOIMASSA	
OH0KXI	VOIMASSA	
OH0KXJ	VOIMASSA	
OH0L	VOIMASSA	
OH0LIH	VOIMASSA	
OH0LO	VOIMASSA	
OH0LRL	VOIMASSA	
OH0LYA	VOIMASSA	
OH0LZU	VOIMASSA	
OH0M	KARENSSI	
OH0MA	VOIMASSA	
OH0MAM	VOIMASSA	
OH0MDR	VOIMASSA	
OH0MEP	VOIMASSA	
OH0MM	VOIMASSA	
OH0MMF	VOIMASSA	
OH0MPM	VOIMASSA	
OH0MPO	VOIMASSA	
OH0MRR	VOIMASSA	
OH0MYL	VOIMASSA	
OH0MZA	VOIMASSA	
OH0N	VOIMASSA	
OH0NA	VOIMASSA	
OH0NAW	VOIMASSA	
OH0NC	VOIMASSA	
OH0NCQ	VOIMASSA	
OH0NH	VOIMASSA	
OH0NJ	VOIMASSA	
OH0NK	VOIMASSA	
OH0NL	VOIMASSA	
OH0NM	VOIMASSA	
OH0NOA	VOIMASSA	
OH0NS	VOIMASSA	
OH0PM	VOIMASSA	
OH0R	VOIMASSA	
OH0RAA	VOIMASSA	
OH0RB	VOIMASSA	
OH0RDZ	VOIMASSA	
OH0RJ	VOIMASSA	
OH0RUA	VOIMASSA	
OH0RUB	VOIMASSA	
OH0S	VOIMASSA	
OH0SGF	VOIMASSA	
OH0SIX	VOIMASSA	
OH0SUF	VOIMASSA	
OH0T	VOIMASSA	
OH0TA	VOIMASSA	
OH0TS	VOIMASSA	
OH0TX	VOIMASSA	
OH0UA	VOIMASSA	
OH0V	VOIMASSA	
OH0W	VOIMASSA	
OH0WH	VOIMASSA	
OH0WW	VOIMASSA	
OH0X	VOIMASSA	
OH0XX	VOIMASSA	
OH0XY	VOIMASSA	
OH0YLS	VOIMASSA	
OH0YY	VOIMASSA	
OH0Z	VOIMASSA	
OH0ZZ	VOIMASSA	
OH100CW	VOIMASSA	
OH100SRAL	VOIMASSA	
OH10A	VOIMASSA	
OH10AS	VOIMASSA	
OH10D	VOIMASSA	
OH10DX	VOIMASSA	
OH10JO	VOIMASSA	
OH10JS	VOIMASSA	
OH10M	VOIMASSA	
OH10N	VOIMASSA	
OH10TA	VOIMASSA	
OH10X	VOIMASSA	
OH11WCA	VOIMASSA	
OH1A	VOIMASSA	
OH1AA	VOIMASSA	
OH1AAA	VOIMASSA	
OH1AB	VOIMASSA	
OH1ABY	VOIMASSA	
OH1AD	VOIMASSA	
OH1AF	VOIMASSA	
OH1AH	VOIMASSA	
OH1AJ	VOIMASSA	
OH1AK	VOIMASSA	
OH1AL	VOIMASSA	
OH1AM	VOIMASSA	
OH1ARMI	VOIMASSA	
OH1AS	VOIMASSA	
OH1AT	VOIMASSA	
OH1AU	VOIMASSA	
OH1AV	VOIMASSA	
OH1AWB	VOIMASSA	
OH1AWD	VOIMASSA	
OH1AWE	VOIMASSA	
OH1AWT	VOIMASSA	
OH1AXT	VOIMASSA	
OH1AXV	VOIMASSA	
OH1AXX	VOIMASSA	
OH1AYA	VOIMASSA	
OH1AYB	VOIMASSA	
OH1AYC	VOIMASSA	
OH1AYF	VOIMASSA	
OH1AYG	VOIMASSA	
OH1AYJ	VOIMASSA	
OH1AYN	VOIMASSA	
OH1AYP	VOIMASSA	
OH1AYQ	VOIMASSA	
OH1AYR	VOIMASSA	
OH1AYY	VOIMASSA	
OH1AZE	VOIMASSA	
OH1AZH	VOIMASSA	
OH1AZL	VOIMASSA	
OH1AZM	VOIMASSA	
OH1AZT	VOIMASSA	
OH1B	VOIMASSA	
OH1BA	VOIMASSA	
OH1BAC	VOIMASSA	
OH1BAD	VOIMASSA	
OH1BAM	VOIMASSA	
OH1BAR	VOIMASSA	
OH1BAW	VOIMASSA	
OH1BB	VOIMASSA	
OH1BBJ	VOIMASSA	
OH1BBS	VOIMASSA	
OH1BC	VOIMASSA	
OH1BDF	VOIMASSA	
OH1BDK	VOIMASSA	
OH1BF	VOIMASSA	
OH1BG	VOIMASSA	
OH1BGG	VOIMASSA	
OH1BH	VOIMASSA	
OH1BHC	VOIMASSA	
OH1BHG	VOIMASSA	
OH1BHH	VOIMASSA	
OH1BHK	VOIMASSA	
OH1BHT	VOIMASSA	
OH1BID	VOIMASSA	
OH1BJC	VOIMASSA	
OH1BJJ	VOIMASSA	
OH1BJM	VOIMASSA	
OH1BK	VOIMASSA	
OH1BKY	VOIMASSA	
OH1BLC	VOIMASSA	
OH1BLM	VOIMASSA	
OH1BM	VOIMASSA	
OH1BMC	VOIMASSA	
OH1BMZ	VOIMASSA	
OH1BN	VOIMASSA	
OH1BNB	VOIMASSA	
OH1BNL	VOIMASSA	
OH1BNO	VOIMASSA	
OH1BO	VOIMASSA	
OH1BOH	VOIMASSA	
OH1BOI	VOIMASSA	
OH1BOM	VOIMASSA	
OH1BOO	VOIMASSA	
OH1BOR	VOIMASSA	
OH1BOS	VOIMASSA	
OH1BP	VOIMASSA	
OH1BPE	VOIMASSA	
OH1BPG	VOIMASSA	
OH1BPK	VOIMASSA	
OH1BPP	VOIMASSA	
OH1BPZ	VOIMASSA	
OH1BQR	VOIMASSA	
OH1BQV	VOIMASSA	
OH1BR	VOIMASSA	
OH1BS	VOIMASSA	
OH1BSD	VOIMASSA	
OH1BSK	VOIMASSA	
OH1BSM	VOIMASSA	
OH1BT	VOIMASSA	
OH1BTR	VOIMASSA	
OH1BUD	VOIMASSA	
OH1BUM	VOIMASSA	
OH1BV	VOIMASSA	
OH1BVD	VOIMASSA	
OH1BVJ	VOIMASSA	
OH1BX	VOIMASSA	
OH1BYK	VOIMASSA	
OH1BYT	VOIMASSA	
OH1BZE	VOIMASSA	
OH1C	VOIMASSA	
OH1CA	VOIMASSA	
OH1CAH	VOIMASSA	
OH1CAK	VOIMASSA	
OH1CAO	VOIMASSA	
OH1CAQ	VOIMASSA	
OH1CAS	VOIMASSA	
OH1CAU	VOIMASSA	
OH1CBU	VOIMASSA	
OH1CBY	VOIMASSA	
OH1CC	VOIMASSA	
OH1CCQ	VOIMASSA	
OH1CCR	VOIMASSA	
OH1CCU	VOIMASSA	
OH1CCV	VOIMASSA	
OH1CD	VOIMASSA	
OH1CDD	VOIMASSA	
OH1CDH	VOIMASSA	
OH1CDP	VOIMASSA	
OH1CDQ	VOIMASSA	
OH1CF	VOIMASSA	
OH1CGF	VOIMASSA	
OH1CGM	VOIMASSA	
OH1CH	VOIMASSA	
OH1CI	VOIMASSA	
OH1CJ	VOIMASSA	
OH1CK	VOIMASSA	
OH1CL	VOIMASSA	
OH1CM	VOIMASSA	
OH1CN	VOIMASSA	
OH1CO	VOIMASSA	
OH1COM	VOIMASSA	
OH1CQ	VOIMASSA	
OH1CR	VOIMASSA	
OH1CS	VOIMASSA	
OH1CT	VOIMASSA	
OH1CW	VOIMASSA	
OH1CX	VOIMASSA	
OH1CY	VOIMASSA	
OH1CZ	VOIMASSA	
OH1D	VOIMASSA	
OH1DA	VOIMASSA	
OH1DB	VOIMASSA	
OH1DC	VOIMASSA	
OH1DD	VOIMASSA	
OH1DI	VOIMASSA	
OH1DJ	VOIMASSA	
OH1DL	VOIMASSA	
OH1DM	VOIMASSA	
OH1DMRA	VOIMASSA	
OH1DO	VOIMASSA	
OH1DP	VOIMASSA	
OH1DV	VOIMASSA	
OH1DW	VOIMASSA	
OH1DX	VOIMASSA	
OH1DY	VOIMASSA	
OH1E	VOIMASSA	
OH1EA	VOIMASSA	
OH1EAI	VOIMASSA	
OH1EAV	VOIMASSA	
OH1EB	VOIMASSA	
OH1EBJ	VOIMASSA	
OH1EBK	VOIMASSA	
OH1EBL	VOIMASSA	
OH1EBM	VOIMASSA	
OH1EBO	VOIMASSA	
OH1EBQ	VOIMASSA	
OH1EBS	VOIMASSA	
OH1EBT	VOIMASSA	
OH1ECE	VOIMASSA	
OH1ECQ	VOIMASSA	
OH1ECX	VOIMASSA	
OH1ED	VOIMASSA	
OH1EDK	VOIMASSA	
OH1EDU	VOIMASSA	
OH1EE	VOIMASSA	
OH1EEB	VOIMASSA	
OH1EER	VOIMASSA	
OH1EEZ	VOIMASSA	
OH1EF	VOIMASSA	
OH1EFQ	VOIMASSA	
OH1EFR	VOIMASSA	
OH1EFW	VOIMASSA	
OH1EG	VOIMASSA	
OH1EGA	VOIMASSA	
OH1EGD	VOIMASSA	
OH1EGE	VOIMASSA	
OH1EGU	VOIMASSA	
OH1EHD	VOIMASSA	
OH1EHH	VOIMASSA	
OH1EHJ	VOIMASSA	
OH1EHL	VOIMASSA	
OH1EHM	VOIMASSA	
OH1EHN	VOIMASSA	
OH1EHX	VOIMASSA	
OH1EIP	VOIMASSA	
OH1EIX	VOIMASSA	
OH1EIY	VOIMASSA	
OH1EJP	VOIMASSA	
OH1EJQ	VOIMASSA	
OH1EKU	VOIMASSA	
OH1EL	VOIMASSA	
OH1ELG	VOIMASSA	
OH1EMX	VOIMASSA	
OH1EMY	VOIMASSA	
OH1ENC	VOIMASSA	
OH1END	VOIMASSA	
OH1ENE	VOIMASSA	
OH1ENY	VOIMASSA	
OH1EOE	VOIMASSA	
OH1EOF	VOIMASSA	
OH1EOK	VOIMASSA	
OH1EOR	VOIMASSA	
OH1EP	VOIMASSA	
OH1EQ	VOIMASSA	
OH1ERB	VOIMASSA	
OH1ES	VOIMASSA	
OH1ESB	VOIMASSA	
OH1ESC	VOIMASSA	
OH1ESD	VOIMASSA	
OH1ESE	VOIMASSA	
OH1ESG	VOIMASSA	
OH1ESI	VOIMASSA	
OH1ESO	VOIMASSA	
OH1ET	VOIMASSA	
OH1ETD	VOIMASSA	
OH1ETH	VOIMASSA	
OH1ETQ	VOIMASSA	
OH1EU	VOIMASSA	
OH1EUD	VOIMASSA	
OH1EUS	VOIMASSA	
OH1EUT	VOIMASSA	
OH1EV	VOIMASSA	
OH1EVE	VOIMASSA	
OH1EWE	VOIMASSA	
OH1EVI	VOIMASSA	
OH1EWR	VOIMASSA	
OH1EWS	VOIMASSA	
OH1EVW	VOIMASSA	
OH1EWY	VOIMASSA	
OH1EWZ	VOIMASSA	
OH1EXC	VOIMASSA	
OH1EXD	VOIMASSA	
OH1EXF	VOIMASSA	
OH1EY	VOIMASSA	
OH1EYC	VOIMASSA	
OH1EYD	VOIMASSA	
OH1EYI	VOIMASSA	
OH1EZB	VOIMASSA	
OH1EZC	VOIMASSA	
OH1EZT	VOIMASSA	
OH1EZV	VOIMASSA	
OH1F	VOIMASSA	
OH1FA	VOIMASSA	
OH1FAB	VOIMASSA	
OH1FAG	VOIMASSA	
OH1FAI	VOIMASSA	
OH1FAP	VOIMASSA	
OH1FAQ	VOIMASSA	
OH1FAW	VOIMASSA	
OH1FAX	VOIMASSA	
OH1FAY	VOIMASSA	
OH1FAZ	VOIMASSA	
OH1FB	VOIMASSA	
OH1FBA	VOIMASSA	
OH1FBC	VOIMASSA	
OH1FBU	VOIMASSA	
OH1FBV	VOIMASSA	
OH1FC	VOIMASSA	
OH1FCU	VOIMASSA	
OH1FCV	VOIMASSA	
OH1FCX	VOIMASSA	
OH1FD	KARENSSI	
OH1FDU	VOIMASSA	
OH1FDW	VOIMASSA	
OH1FEB	VOIMASSA	
OH1FEK	VOIMASSA	
OH1FEL	VOIMASSA	
OH1FEN	VOIMASSA	
OH1FEO	VOIMASSA	
OH1FEP	VOIMASSA	
OH1FEQ	VOIMASSA	
OH1FEU	VOIMASSA	
OH1FF	VOIMASSA	
OH1FFJ	VOIMASSA	
OH1FFK	VOIMASSA	
OH1FFN	VOIMASSA	
OH1FGL	VOIMASSA	
OH1FGY	VOIMASSA	
OH1FH	VOIMASSA	
OH1FHA	VOIMASSA	
OH1FI	VOIMASSA	
OH1FIX	VOIMASSA	
OH1FJ	VOIMASSA	
OH1FJR	VOIMASSA	
OH1FJV	VOIMASSA	
OH1FJY	VOIMASSA	
OH1FJZ	VOIMASSA	
OH1FKA	VOIMASSA	
OH1FKB	VOIMASSA	
OH1FKC	VOIMASSA	
OH1FLS	VOIMASSA	
OH1FLT	VOIMASSA	
OH1FLU	VOIMASSA	
OH1FLY	VOIMASSA	
OH1FM	VOIMASSA	
OH1FMA	VOIMASSA	
OH1FNJ	VOIMASSA	
OH1FNK	VOIMASSA	
OH1FNL	VOIMASSA	
OH1FNY	VOIMASSA	
OH1FO	VOIMASSA	
OH1FOF	VOIMASSA	
OH1FOL	VOIMASSA	
OH1FOU	VOIMASSA	
OH1FP	VOIMASSA	
OH1FPA	VOIMASSA	
OH1FPZ	VOIMASSA	
OH1FQD	VOIMASSA	
OH1FQG	VOIMASSA	
OH1FQY	VOIMASSA	
OH1FQZ	VOIMASSA	
OH1FRA	VOIMASSA	
OH1FRC	VOIMASSA	
OH1FRO	VOIMASSA	
OH1FS	VOIMASSA	
OH1FSS	VOIMASSA	
OH1FT	VOIMASSA	
OH1FTT	VOIMASSA	
OH1FU	VOIMASSA	
OH1FUS	VOIMASSA	
OH1FUX	VOIMASSA	
OH1FVN	VOIMASSA	
OH1FVO	VOIMASSA	
OH1FWP	VOIMASSA	
OH1FWU	VOIMASSA	
OH1FWW	VOIMASSA	
OH1FWX	VOIMASSA	
OH1FXE	VOIMASSA	
OH1FYJ	VOIMASSA	
OH1FYK	VOIMASSA	
OH1FYL	VOIMASSA	
OH1GBC	VOIMASSA	
OH1GBD	VOIMASSA	
OH1GC	KARENSSI	
OH1GEL	VOIMASSA	
OH1GEM	VOIMASSA	
OH1GEN	VOIMASSA	
OH1GEO	VOIMASSA	
OH1GF	VOIMASSA	
OH1GFN	VOIMASSA	
OH1GFU	VOIMASSA	
OH1GFW	VOIMASSA	
OH1GGJ	VOIMASSA	
OH1GI	VOIMASSA	
OH1GIU	VOIMASSA	
OH1GIV	VOIMASSA	
OH1GIW	VOIMASSA	
OH1GIY	VOIMASSA	
OH1GJ	VOIMASSA	
OH1GJN	VOIMASSA	
OH1GJQ	VOIMASSA	
OH1GJR	VOIMASSA	
OH1GJS	VOIMASSA	
OH1GJV	VOIMASSA	
OH1GKU	VOIMASSA	
OH1GL	VOIMASSA	
OH1GMN	VOIMASSA	
OH1GMP	VOIMASSA	
OH1GNJ	VOIMASSA	
OH1GOK	VOIMASSA	
OH1GOV	VOIMASSA	
OH1GPA	VOIMASSA	
OH1GPE	VOIMASSA	
OH1GPR	VOIMASSA	
OH1GPU	VOIMASSA	
OH1GPW	VOIMASSA	
OH1GPX	VOIMASSA	
OH1GQB	VOIMASSA	
OH1GR	VOIMASSA	
OH1GRI	VOIMASSA	
OH1GRL	VOIMASSA	
OH1GRN	VOIMASSA	
OH1GRT	VOIMASSA	
OH1GRU	VOIMASSA	
OH1GRV	VOIMASSA	
OH1GRZ	VOIMASSA	
OH1GSM	VOIMASSA	
OH1GT	VOIMASSA	
OH1GTW	VOIMASSA	
OH1GU	VOIMASSA	
OH1GUM	VOIMASSA	
OH1GUN	VOIMASSA	
OH1GUR	VOIMASSA	
OH1GWK	VOIMASSA	
OH1GWL	VOIMASSA	
OH1GVR	VOIMASSA	
OH1GX	VOIMASSA	
OH1GXW	VOIMASSA	
OH1GYY	VOIMASSA	
OH1GZ	VOIMASSA	
OH1H	VOIMASSA	
OH1HA	VOIMASSA	
OH1HAF	VOIMASSA	
OH1HAQ	VOIMASSA	
OH1HB	VOIMASSA	
OH1HBT	VOIMASSA	
OH1HCF	VOIMASSA	
OH1HCO	VOIMASSA	
OH1HD	VOIMASSA	
OH1HDT	VOIMASSA	
OH1HE	VOIMASSA	
OH1HEK	VOIMASSA	
OH1HF	VOIMASSA	
OH1HFP	VOIMASSA	
OH1HFV	VOIMASSA	
OH1HFZ	VOIMASSA	
OH1HG	VOIMASSA	
OH1HGG	VOIMASSA	
OH1HGH	VOIMASSA	
OH1HGM	VOIMASSA	
OH1HGR	VOIMASSA	
OH1HHT	VOIMASSA	
OH1HHY	VOIMASSA	
OH1HIH	VOIMASSA	
OH1HIT	VOIMASSA	
OH1HJN	VOIMASSA	
OH1HJO	VOIMASSA	
OH1HKG	VOIMASSA	
OH1HKN	VOIMASSA	
OH1HL	VOIMASSA	
OH1HM	VOIMASSA	
OH1HN	KARENSSI	
OH1HO	VOIMASSA	
OH1HOG	VOIMASSA	
OH1HOQ	VOIMASSA	
OH1HOZ	VOIMASSA	
OH1HPZ	VOIMASSA	
OH1HQZ	VOIMASSA	
OH1HR	VOIMASSA	
OH1HS	VOIMASSA	
OH1HSC	VOIMASSA	
OH1HSF	VOIMASSA	
OH1HSN	VOIMASSA	
OH1HU	VOIMASSA	
OH1HUE	VOIMASSA	
OH1HUP	VOIMASSA	
OH1HUQ	VOIMASSA	
OH1HWA	VOIMASSA	
OH1HWB	VOIMASSA	
OH1HWC	VOIMASSA	
OH1HWD	VOIMASSA	
OH1HWK	VOIMASSA	
OH1HWT	VOIMASSA	
OH1HVY	VOIMASSA	
OH1HX	VOIMASSA	
OH1HZC	VOIMASSA	
OH1HZR	VOIMASSA	
OH1HZZ	VOIMASSA	
OH1IB	VOIMASSA	
OH1IC	VOIMASSA	
OH1ID	VOIMASSA	
OH1II	KARENSSI	
OH1IJ	VOIMASSA	
OH1IM	VOIMASSA	
OH1IN	VOIMASSA	
OH1IR	VOIMASSA	
OH1IU	VOIMASSA	
OH1IW	VOIMASSA	
OH1IX	VOIMASSA	
OH1J	VOIMASSA	
OH1JA	VOIMASSA	
OH1JAME	VOIMASSA	
OH1JAW	VOIMASSA	
OH1JAY	VOIMASSA	
OH1JB	VOIMASSA	
OH1JCF	VOIMASSA	
OH1JCG	VOIMASSA	
OH1JCI	VOIMASSA	
OH1JCS	VOIMASSA	
OH1JD	VOIMASSA	
OH1JDB	VOIMASSA	
OH1JDM	VOIMASSA	
OH1JEW	VOIMASSA	
OH1JEX	VOIMASSA	
OH1JEZ	VOIMASSA	
OH1JF	VOIMASSA	
OH1JFD	VOIMASSA	
OH1JFW	VOIMASSA	
OH1JG	VOIMASSA	
OH1JGB	VOIMASSA	
OH1JH	VOIMASSA	
OH1JHG	VOIMASSA	
OH1JHO	VOIMASSA	
OH1JHX	VOIMASSA	
OH1JI	VOIMASSA	
OH1JJ	KARENSSI	
OH1JJH	VOIMASSA	
OH1JJO	VOIMASSA	
OH1JK	VOIMASSA	
OH1JKE	VOIMASSA	
OH1JKP	VOIMASSA	
OH1JL	VOIMASSA	
OH1JLC	VOIMASSA	
OH1JLD	VOIMASSA	
OH1JLT	VOIMASSA	
OH1JM	VOIMASSA	
OH1JNG	VOIMASSA	
OH1JO	VOIMASSA	
OH1JOD	VOIMASSA	
OH1JP	VOIMASSA	
OH1JPA	VOIMASSA	
OH1JPH	VOIMASSA	
OH1JQ	VOIMASSA	
OH1JQY	VOIMASSA	
OH1JR	VOIMASSA	
OH1JS	VOIMASSA	
OH1JSY	VOIMASSA	
OH1JT	VOIMASSA	
OH1JTL	VOIMASSA	
OH1JTP	VOIMASSA	
OH1JTY	VOIMASSA	
OH1JUJ	VOIMASSA	
OH1JUS	VOIMASSA	
OH1JUU	VOIMASSA	
OH1JW	VOIMASSA	
OH1JVQ	VOIMASSA	
OH1JWS	VOIMASSA	
OH1JX	VOIMASSA	
OH1JXS	VOIMASSA	
OH1JY	VOIMASSA	
OH1JYJ	VOIMASSA	
OH1JYQ	VOIMASSA	
OH1JZ	VOIMASSA	
OH1JZK	VOIMASSA	
OH1JZY	VOIMASSA	
OH1JZZ	VOIMASSA	
OH1K	VOIMASSA	
OH1KA	VOIMASSA	
OH1KAG	VOIMASSA	
OH1KAO	VOIMASSA	
OH1KAP	VOIMASSA	
OH1KB	VOIMASSA	
OH1KBI	VOIMASSA	
OH1KBM	VOIMASSA	
OH1KBX	VOIMASSA	
OH1KC	VOIMASSA	
OH1KCY	VOIMASSA	
OH1KD	VOIMASSA	
OH1KDI	VOIMASSA	
OH1KDM	VOIMASSA	
OH1KDT	VOIMASSA	
OH1KE	VOIMASSA	
OH1KF	KARENSSI	
OH1KFL	VOIMASSA	
OH1KGK	VOIMASSA	
OH1KGO	VOIMASSA	
OH1KH	VOIMASSA	
OH1KI	VOIMASSA	
OH1KII	VOIMASSA	
OH1KIO	VOIMASSA	
OH1KIU	VOIMASSA	
OH1KJ	VOIMASSA	
OH1KJJ	VOIMASSA	
OH1KK	VOIMASSA	
OH1KKD	VOIMASSA	
OH1KL	VOIMASSA	
OH1KLL	VOIMASSA	
OH1KM	VOIMASSA	
OH1KMB	VOIMASSA	
OH1KO	VOIMASSA	
OH1KPG	VOIMASSA	
OH1KPR	VOIMASSA	
OH1KPX	VOIMASSA	
OH1KQS	VOIMASSA	
OH1KQX	VOIMASSA	
OH1KR	VOIMASSA	
OH1KRC	VOIMASSA	
OH1KS	VOIMASSA	
OH1KSC	VOIMASSA	
OH1KSD	VOIMASSA	
OH1KSP	VOIMASSA	
OH1KT	VOIMASSA	
OH1KTK	VOIMASSA	
OH1KU	VOIMASSA	
OH1KUE	VOIMASSA	
OH1KW	VOIMASSA	
OH1KVD	VOIMASSA	
OH1KYL	VOIMASSA	
OH1KYN	VOIMASSA	
OH1KYQ	VOIMASSA	
OH1KYT	VOIMASSA	
OH1KZ	VOIMASSA	
OH1KZI	VOIMASSA	
OH1KZN	VOIMASSA	
OH1LA	VOIMASSA	
OH1LAN	VOIMASSA	
OH1LAR	VOIMASSA	
OH1LAU	VOIMASSA	
OH1LAY	VOIMASSA	
OH1LD	VOIMASSA	
OH1LDB	VOIMASSA	
OH1LDI	VOIMASSA	
OH1LEG	VOIMASSA	
OH1LEM	VOIMASSA	
OH1LEO	VOIMASSA	
OH1LEU	VOIMASSA	
OH1LEX	VOIMASSA	
OH1LFF	VOIMASSA	
OH1LFX	VOIMASSA	
OH1LG	VOIMASSA	
OH1LH	VOIMASSA	
OH1LI	VOIMASSA	
OH1LIO	VOIMASSA	
OH1LJX	VOIMASSA	
OH1LK	VOIMASSA	
OH1LKH	VOIMASSA	
OH1LL	KARENSSI	
OH1LLA	VOIMASSA	
OH1LLE	VOIMASSA	
OH1LLL	VOIMASSA	
OH1LLM	VOIMASSA	
OH1LLN	VOIMASSA	
OH1LM	VOIMASSA	
OH1LMD	VOIMASSA	
OH1LMH	VOIMASSA	
OH1LO	VOIMASSA	
OH1LOK	VOIMASSA	
OH1LP	VOIMASSA	
OH1LPC	VOIMASSA	
OH1LPJ	VOIMASSA	
OH1LPU	VOIMASSA	
OH1LQ	VOIMASSA	
OH1LQP	VOIMASSA	
OH1LQR	VOIMASSA	
OH1LR	VOIMASSA	
OH1LRY	VOIMASSA	
OH1LSQ	VOIMASSA	
OH1LT	VOIMASSA	
OH1LTM	VOIMASSA	
OH1LTT	VOIMASSA	
OH1LTU	VOIMASSA	
OH1LTV	VOIMASSA	
OH1LU	KARENSSI	
OH1LUB	VOIMASSA	
OH1LUI	VOIMASSA	
OH1LUZ	VOIMASSA	
OH1LWA	VOIMASSA	
OH1LVB	VOIMASSA	
OH1LWB	VOIMASSA	
OH1LWG	VOIMASSA	
OH1LVK	VOIMASSA	
OH1LVL	VOIMASSA	
OH1LWQ	VOIMASSA	
OH1LWZ	VOIMASSA	
OH1LX	VOIMASSA	
OH1LXF	VOIMASSA	
OH1LYZ	VOIMASSA	
OH1LZ	VOIMASSA	
OH1LZM	VOIMASSA	
OH1M	VOIMASSA	
OH1MA	VOIMASSA	
OH1MAC	VOIMASSA	
OH1MAI	VOIMASSA	
OH1MAR	VOIMASSA	
OH1MAU	VOIMASSA	
OH1MAW	VOIMASSA	
OH1MCW	VOIMASSA	
OH1MD	VOIMASSA	
OH1MDR	VOIMASSA	
OH1ME	VOIMASSA	
OH1MEB	VOIMASSA	
OH1MEQ	VOIMASSA	
OH1MET	VOIMASSA	
OH1MFL	VOIMASSA	
OH1MG	VOIMASSA	
OH1MGG	VOIMASSA	
OH1MGR	VOIMASSA	
OH1MGU	VOIMASSA	
OH1MH	VOIMASSA	
OH1MHX	VOIMASSA	
OH1MI	VOIMASSA	
OH1MID	VOIMASSA	
OH1MIE	VOIMASSA	
OH1MIJ	VOIMASSA	
OH1MIV	VOIMASSA	
OH1MJ	VOIMASSA	
OH1MK	VOIMASSA	
OH1MKV	VOIMASSA	
OH1ML	VOIMASSA	
OH1MLB	VOIMASSA	
OH1MLI	VOIMASSA	
OH1MLR	VOIMASSA	
OH1MLZ	VOIMASSA	
OH1MM	VOIMASSA	
OH1MMA	VOIMASSA	
OH1MMB	VOIMASSA	
OH1MMU	VOIMASSA	
OH1MN	VOIMASSA	
OH1MND	VOIMASSA	
OH1MNP	VOIMASSA	
OH1MOZ	VOIMASSA	
OH1MP	VOIMASSA	
OH1MQ	VOIMASSA	
OH1MQI	VOIMASSA	
OH1MQK	VOIMASSA	
OH1MR	VOIMASSA	
OH1MRE	VOIMASSA	
OH1MRH	VOIMASSA	
OH1MRN	VOIMASSA	
OH1MRQ	VOIMASSA	
OH1MRR	VOIMASSA	
OH1MS	VOIMASSA	
OH1MT	VOIMASSA	
OH1MTD	VOIMASSA	
OH1MTS	VOIMASSA	
OH1MTT	VOIMASSA	
OH1MTZ	VOIMASSA	
OH1MU	VOIMASSA	
OH1MUR	VOIMASSA	
OH1MUV	VOIMASSA	
OH1MUW	VOIMASSA	
OH1MV	VOIMASSA	
OH1MW	VOIMASSA	
OH1MVA	VOIMASSA	
OH1MVM	VOIMASSA	
OH1MVP	VOIMASSA	
OH1MY	VOIMASSA	
OH1MYA	VOIMASSA	
OH1MYG	VOIMASSA	
OH1MYH	VOIMASSA	
OH1MYT	VOIMASSA	
OH1MZ	VOIMASSA	
OH1MZI	VOIMASSA	
OH1MZR	VOIMASSA	
OH1N	VOIMASSA	
OH1NA	KARENSSI	
OH1NAD	VOIMASSA	
OH1NAVY	VOIMASSA	
OH1NBF	VOIMASSA	
OH1NBX	VOIMASSA	
OH1NC	VOIMASSA	
OH1ND	VOIMASSA	
OH1NDA	VOIMASSA	
OH1NE	VOIMASSA	
OH1NEI	VOIMASSA	
OH1NER	VOIMASSA	
OH1NET	VOIMASSA	
OH1NFW	VOIMASSA	
OH1NG	VOIMASSA	
OH1NGD	VOIMASSA	
OH1NHL	VOIMASSA	
OH1NHU	VOIMASSA	
OH1NHW	VOIMASSA	
OH1NHX	VOIMASSA	
OH1NIA	VOIMASSA	
OH1NIL	VOIMASSA	
OH1NJN	VOIMASSA	
OH1NK	VOIMASSA	
OH1NM	KARENSSI	
OH1NMX	VOIMASSA	
OH1NN	VOIMASSA	
OH1NNR	VOIMASSA	
OH1NNW	VOIMASSA	
OH1NNX	VOIMASSA	
OH1NNY	VOIMASSA	
OH1NO	VOIMASSA	
OH1NOA	VOIMASSA	
OH1NOI	VOIMASSA	
OH1NOM	VOIMASSA	
OH1NP	KARENSSI	
OH1NPM	VOIMASSA	
OH1NPW	VOIMASSA	
OH1NQ	VOIMASSA	
OH1NR	VOIMASSA	
OH1NRR	VOIMASSA	
OH1NS	VOIMASSA	
OH1NTI	VOIMASSA	
OH1NTN	VOIMASSA	
OH1NVB	VOIMASSA	
OH1NVL	VOIMASSA	
OH1NVW	VOIMASSA	
OH1NX	VOIMASSA	
OH1NYD	VOIMASSA	
OH1NYKI	VOIMASSA	
OH1NZQ	VOIMASSA	
OH1NZT	VOIMASSA	
OH1NZU	VOIMASSA	
OH1O	VOIMASSA	
OH1OD	VOIMASSA	
OH1OF	VOIMASSA	
OH1OH	VOIMASSA	
OH1OLU	VOIMASSA	
OH1ON	VOIMASSA	
OH1OP	VOIMASSA	
OH1OR	VOIMASSA	
OH1OW	VOIMASSA	
OH1OY	VOIMASSA	
OH1PE	VOIMASSA	
OH1PF	VOIMASSA	
OH1PG	VOIMASSA	
OH1PH	VOIMASSA	
OH1PI	VOIMASSA	
OH1PK	VOIMASSA	
OH1PL	VOIMASSA	
OH1PN	KARENSSI	
OH1POR	VOIMASSA	
OH1PP	VOIMASSA	
OH1PRA	VOIMASSA	
OH1PS	VOIMASSA	
OH1PU	VOIMASSA	
OH1PW	VOIMASSA	
OH1PY	VOIMASSA	
OH1PZ	VOIMASSA	
OH1QA	VOIMASSA	
OH1QC	VOIMASSA	
OH1QF	VOIMASSA	
OH1QG	VOIMASSA	
OH1QK	VOIMASSA	
OH1QQ	VOIMASSA	
OH1QS	VOIMASSA	
OH1QT	VOIMASSA	
OH1QX	VOIMASSA	
OH1R	VOIMASSA	
OH1RA	VOIMASSA	
OH1RAA	VOIMASSA	
OH1RAB	VOIMASSA	
OH1RAD	VOIMASSA	
OH1RAE	VOIMASSA	
OH1RAI	VOIMASSA	
OH1RAU	VOIMASSA	
OH1RCF	VOIMASSA	
OH1RDK	VOIMASSA	
OH1RDS	VOIMASSA	
OH1RDU	VOIMASSA	
OH1RDW	VOIMASSA	
OH1RF	VOIMASSA	
OH1RHU	VOIMASSA	
OH1RI	VOIMASSA	
OH1RJ	VOIMASSA	
OH1RK	VOIMASSA	
OH1RL	VOIMASSA	
OH1RM	VOIMASSA	
OH1RR	VOIMASSA	
OH1RT	VOIMASSA	
OH1RUB	VOIMASSA	
OH1RUD	VOIMASSA	
OH1RUF	VOIMASSA	
OH1RUG	VOIMASSA	
OH1RUH	VOIMASSA	
OH1RUK	VOIMASSA	
OH1RUL	VOIMASSA	
OH1RUM	VOIMASSA	
OH1RUN	VOIMASSA	
OH1RV	VOIMASSA	
OH1RX	VOIMASSA	
OH1RY	VOIMASSA	
OH1RZ	VOIMASSA	
OH1S	VOIMASSA	
OH1SA	VOIMASSA	
OH1SALO	VOIMASSA	
OH1SAM	VOIMASSA	
OH1SD	VOIMASSA	
OH1SDR	VOIMASSA	
OH1SG	VOIMASSA	
OH1SH	KARENSSI	
OH1SHF	VOIMASSA	
OH1SIC	VOIMASSA	
OH1SJ	VOIMASSA	
OH1SM	VOIMASSA	
OH1SO	VOIMASSA	
OH1SP	KARENSSI	
OH1SR	VOIMASSA	
OH1SRA	VOIMASSA	
OH1SS	KARENSSI	
OH1SU	VOIMASSA	
OH1SUF	VOIMASSA	
OH1SV	VOIMASSA	
OH1SX	VOIMASSA	
OH1T	VOIMASSA	
OH1TA	VOIMASSA	
OH1TD	VOIMASSA	
OH1TE	VOIMASSA	
OH1TG	KARENSSI	
OH1TH	VOIMASSA	
OH1TIN	VOIMASSA	
OH1TJ	VOIMASSA	
OH1TK	VOIMASSA	
OH1TL	VOIMASSA	
OH1TM	VOIMASSA	
OH1TN	VOIMASSA	
OH1TP	VOIMASSA	
OH1TR	VOIMASSA	
OH1TS	VOIMASSA	
OH1TSM	VOIMASSA	
OH1TT	VOIMASSA	
OH1TU	VOIMASSA	
OH1TV	VOIMASSA	
OH1TW	VOIMASSA	
OH1TX	VOIMASSA	
OH1TY	VOIMASSA	
OH1TZ	KARENSSI	
OH1UAC	VOIMASSA	
OH1UBH	VOIMASSA	
OH1UBO	VOIMASSA	
OH1UBS	VOIMASSA	
OH1UCK	VOIMASSA	
OH1UCM	VOIMASSA	
OH1UCN	VOIMASSA	
OH1UCS	VOIMASSA	
OH1UDC	VOIMASSA	
OH1UDE	VOIMASSA	
OH1UE	VOIMASSA	
OH1UG	VOIMASSA	
OH1UH	VOIMASSA	
OH1UJ	VOIMASSA	
OH1UK	VOIMASSA	
OH1UL	VOIMASSA	
OH1UM	VOIMASSA	
OH1UP	VOIMASSA	
OH1UQ	VOIMASSA	
OH1US	VOIMASSA	
OH1UU	KARENSSI	
OH1UV	KARENSSI	
OH1UZ	VOIMASSA	
OH1WA	VOIMASSA	
OH1WD	VOIMASSA	
OH1VE	VOIMASSA	
OH1WE	VOIMASSA	
OH1VESA	VOIMASSA	
OH1WF	VOIMASSA	
OH1VG	VOIMASSA	
OH1WH	VOIMASSA	
OH1WI	VOIMASSA	
OH1VJ	VOIMASSA	
OH1WJ	KARENSSI	
OH1WM	VOIMASSA	
OH1WOW	VOIMASSA	
OH1VR	VOIMASSA	
OH1WR	VOIMASSA	
OH1WS	VOIMASSA	
OH1VT	VOIMASSA	
OH1WT	VOIMASSA	
OH1WU	VOIMASSA	
OH1WX	VOIMASSA	
OH1WZ	VOIMASSA	
OH1X	VOIMASSA	
OH1XA	VOIMASSA	
OH1XD	VOIMASSA	
OH1XE	VOIMASSA	
OH1XF	VOIMASSA	
OH1XFE	VOIMASSA	
OH1XG	VOIMASSA	
OH1XH	VOIMASSA	
OH1XN	VOIMASSA	
OH1XP	KARENSSI	
OH1XPD	VOIMASSA	
OH1XQ	VOIMASSA	
OH1XS	VOIMASSA	
OH1XT	VOIMASSA	
OH1XU	VOIMASSA	
OH1XW	VOIMASSA	
OH1XX	VOIMASSA	
OH1XY	VOIMASSA	
OH1XYZ	VOIMASSA	
OH1YA	VOIMASSA	
OH1YB	VOIMASSA	
OH1YF	VOIMASSA	
OH1YKS	VOIMASSA	
OH1YL	VOIMASSA	
OH1YM	VOIMASSA	
OH1YO	VOIMASSA	
OH1YP	VOIMASSA	
OH1YW	VOIMASSA	
OH1YX	VOIMASSA	
OH1Z	VOIMASSA	
OH1ZAA	VOIMASSA	
OH1ZE	VOIMASSA	
OH1ZF	VOIMASSA	
OH1ZH	VOIMASSA	
OH1ZJ	VOIMASSA	
OH1ZK	VOIMASSA	
OH1ZN	VOIMASSA	
OH1ZW	VOIMASSA	
OH1ZZ	VOIMASSA	
OH22AH	KARENSSI	
OH2A	VOIMASSA	
OH2A1S	VOIMASSA	
OH2AA	VOIMASSA	
OH2AAB	VOIMASSA	
OH2AAF	VOIMASSA	
OH2AAV	VOIMASSA	
OH2AAZ	VOIMASSA	
OH2AB	KARENSSI	
OH2ABB	VOIMASSA	
OH2ABF	VOIMASSA	
OH2ABH	VOIMASSA	
OH2ABO	VOIMASSA	
OH2ABX	VOIMASSA	
OH2ABZ	VOIMASSA	
OH2AD	VOIMASSA	
OH2AGS	VOIMASSA	
OH2AH	VOIMASSA	
OH2AI	KARENSSI	
OH2AINA	VOIMASSA	
OH2AL	KARENSSI	
OH2AM	VOIMASSA	
OH2AN	VOIMASSA	
OH2ANDY	VOIMASSA	
OH2AP	VOIMASSA	
OH2AQ	VOIMASSA	
OH2AR	VOIMASSA	
OH2AS	VOIMASSA	
OH2AUA	VOIMASSA	
OH2AUB	VOIMASSA	
OH2AUC	VOIMASSA	
OH2AUE	VOIMASSA	
OH2AUK	VOIMASSA	
OH2AUM	VOIMASSA	
OH2AUN	VOIMASSA	
OH2AUP	VOIMASSA	
OH2AUR	VOIMASSA	
OH2AUS	VOIMASSA	
OH2AUT	VOIMASSA	
OH2AUW	VOIMASSA	
OH2AV	VOIMASSA	
OH2AVD	VOIMASSA	
OH2AVF	VOIMASSA	
OH2AWF	VOIMASSA	
OH2AWG	VOIMASSA	
OH2AWI	VOIMASSA	
OH2AWK	VOIMASSA	
OH2AWL	VOIMASSA	
OH2AWM	VOIMASSA	
OH2AVN	VOIMASSA	
OH2AVP	VOIMASSA	
OH2AWP	VOIMASSA	
OH2AVQ	VOIMASSA	
OH2AWQ	VOIMASSA	
OH2AWS	VOIMASSA	
OH2AWT	VOIMASSA	
OH2AWU	VOIMASSA	
OH2AWV	VOIMASSA	
OH2AWX	VOIMASSA	
OH2AXB	VOIMASSA	
OH2AXD	VOIMASSA	
OH2AXE	VOIMASSA	
OH2AXH	VOIMASSA	
OH2AXL	VOIMASSA	
OH2AXO	VOIMASSA	
OH2AXQ	VOIMASSA	
OH2AXU	VOIMASSA	
OH2AXW	VOIMASSA	
OH2AXZ	VOIMASSA	
OH2AY	VOIMASSA	
OH2AYD	VOIMASSA	
OH2AYP	VOIMASSA	
OH2AYV	VOIMASSA	
OH2AZC	VOIMASSA	
OH2AZE	VOIMASSA	
OH2AZI	VOIMASSA	
OH2AZZ	VOIMASSA	
OH2B	VOIMASSA	
OH2BA	VOIMASSA	
OH2BAD	VOIMASSA	
OH2BAF	VOIMASSA	
OH2BAG	VOIMASSA	
OH2BAH	VOIMASSA	
OH2BAI	VOIMASSA	
OH2BAJ	VOIMASSA	
OH2BAN	VOIMASSA	
OH2BAP	VOIMASSA	
OH2BAQ	VOIMASSA	
OH2BAS	VOIMASSA	
OH2BAT	VOIMASSA	
OH2BAU	VOIMASSA	
OH2BAV	VOIMASSA	
OH2BAX	VOIMASSA	
OH2BAY	VOIMASSA	
OH2BAZ	VOIMASSA	
OH2BB	VOIMASSA	
OH2BBC	VOIMASSA	
OH2BBD	VOIMASSA	
OH2BBE	VOIMASSA	
OH2BBG	VOIMASSA	
OH2BBH	VOIMASSA	
OH2BBL	VOIMASSA	
OH2BBM	VOIMASSA	
OH2BBP	VOIMASSA	
OH2BBT	VOIMASSA	
OH2BBU	VOIMASSA	
OH2BBV	VOIMASSA	
OH2BBW	VOIMASSA	
OH2BBZ	VOIMASSA	
OH2BC	VOIMASSA	
OH2BCB	VOIMASSA	
OH2BCC	VOIMASSA	
OH2BCD	VOIMASSA	
OH2BCE	VOIMASSA	
OH2BCG	VOIMASSA	
OH2BCH	VOIMASSA	
OH2BCI	VOIMASSA	
OH2BCJ	VOIMASSA	
OH2BCK	VOIMASSA	
OH2BCO	VOIMASSA	
OH2BCP	VOIMASSA	
OH2BCQ	VOIMASSA	
OH2BCR	VOIMASSA	
OH2BCV	VOIMASSA	
OH2BCY	VOIMASSA	
OH2BD	VOIMASSA	
OH2BDA	VOIMASSA	
OH2BDB	VOIMASSA	
OH2BDC	VOIMASSA	
OH2BDD	VOIMASSA	
OH2BDG	VOIMASSA	
OH2BDH	VOIMASSA	
OH2BDJ	VOIMASSA	
OH2BDL	VOIMASSA	
OH2BDP	VOIMASSA	
OH2BDQ	VOIMASSA	
OH2BDT	VOIMASSA	
OH2BDV	VOIMASSA	
OH2BDW	VOIMASSA	
OH2BDZ	VOIMASSA	
OH2BE	VOIMASSA	
OH2BEA	VOIMASSA	
OH2BEB	VOIMASSA	
OH2BEC	VOIMASSA	
OH2BEE	VOIMASSA	
OH2BEF	VOIMASSA	
OH2BEG	VOIMASSA	
OH2BEH	VOIMASSA	
OH2BEI	VOIMASSA	
OH2BEJ	VOIMASSA	
OH2BEK	VOIMASSA	
OH2BEN	VOIMASSA	
OH2BEO	VOIMASSA	
OH2BEP	VOIMASSA	
OH2BES	VOIMASSA	
OH2BEU	VOIMASSA	
OH2BEV	VOIMASSA	
OH2BEW	VOIMASSA	
OH2BF	VOIMASSA	
OH2BFA	VOIMASSA	
OH2BFC	VOIMASSA	
OH2BFE	VOIMASSA	
OH2BFF	VOIMASSA	
OH2BFG	VOIMASSA	
OH2BFH	VOIMASSA	
OH2BFK	VOIMASSA	
OH2BFM	VOIMASSA	
OH2BFN	VOIMASSA	
OH2BFO	VOIMASSA	
OH2BFP	VOIMASSA	
OH2BFR	VOIMASSA	
OH2BFS	VOIMASSA	
OH2BFU	VOIMASSA	
OH2BFZ	VOIMASSA	
OH2BG	VOIMASSA	
OH2BGA	VOIMASSA	
OH2BGB	VOIMASSA	
OH2BGC	VOIMASSA	
OH2BGD	VOIMASSA	
OH2BGG	VOIMASSA	
OH2BGH	VOIMASSA	
OH2BGI	VOIMASSA	
OH2BGJ	VOIMASSA	
OH2BGK	VOIMASSA	
OH2BGN	VOIMASSA	
OH2BGO	VOIMASSA	
OH2BGR	VOIMASSA	
OH2BGU	VOIMASSA	
OH2BGV	VOIMASSA	
OH2BGW	VOIMASSA	
OH2BGX	VOIMASSA	
OH2BH	VOIMASSA	
OH2BHA	VOIMASSA	
OH2BHB	VOIMASSA	
OH2BHE	VOIMASSA	
OH2BHF	VOIMASSA	
OH2BHI	VOIMASSA	
OH2BHO	VOIMASSA	
OH2BHP	VOIMASSA	
OH2BHR	VOIMASSA	
OH2BHS	VOIMASSA	
OH2BHU	VOIMASSA	
OH2BHV	VOIMASSA	
OH2BHY	VOIMASSA	
OH2BI	VOIMASSA	
OH2BIA	VOIMASSA	
OH2BIB	VOIMASSA	
OH2BIF	VOIMASSA	
OH2BIG	VOIMASSA	
OH2BIH	VOIMASSA	
OH2BIJ	VOIMASSA	
OH2BIL	VOIMASSA	
OH2BIN	VOIMASSA	
OH2BIO	VOIMASSA	
OH2BIP	VOIMASSA	
OH2BIR	VOIMASSA	
OH2BIS	VOIMASSA	
OH2BIT	VOIMASSA	
OH2BIW	VOIMASSA	
OH2BIX	VOIMASSA	
OH2BIY	VOIMASSA	
OH2BIZ	VOIMASSA	
OH2BJ	VOIMASSA	
OH2BJA	VOIMASSA	
OH2BJB	VOIMASSA	
OH2BJD	VOIMASSA	
OH2BJE	VOIMASSA	
OH2BJF	VOIMASSA	
OH2BJG	VOIMASSA	
OH2BJH	VOIMASSA	
OH2BJI	VOIMASSA	
OH2BJK	VOIMASSA	
OH2BJN	VOIMASSA	
OH2BJO	VOIMASSA	
OH2BJT	VOIMASSA	
OH2BJU	VOIMASSA	
OH2BK	VOIMASSA	
OH2BKC	VOIMASSA	
OH2BKE	VOIMASSA	
OH2BKF	VOIMASSA	
OH2BKH	VOIMASSA	
OH2BKK	VOIMASSA	
OH2BKQ	VOIMASSA	
OH2BKS	VOIMASSA	
OH2BKX	VOIMASSA	
OH2BKZ	VOIMASSA	
OH2BL	VOIMASSA	
OH2BLD	VOIMASSA	
OH2BLE	VOIMASSA	
OH2BLF	VOIMASSA	
OH2BLI	VOIMASSA	
OH2BLK	VOIMASSA	
OH2BLL	VOIMASSA	
OH2BLN	VOIMASSA	
OH2BLO	VOIMASSA	
OH2BLP	VOIMASSA	
OH2BLQ	VOIMASSA	
OH2BLS	VOIMASSA	
OH2BLU	VOIMASSA	
OH2BLV	VOIMASSA	
OH2BLX	VOIMASSA	
OH2BLY	VOIMASSA	
OH2BLZ	VOIMASSA	
OH2BM	VOIMASSA	
OH2BMB	VOIMASSA	
OH2BMD	VOIMASSA	
OH2BME	VOIMASSA	
OH2BMG	VOIMASSA	
OH2BMH	VOIMASSA	
OH2BMJ	VOIMASSA	
OH2BML	VOIMASSA	
OH2BMM	VOIMASSA	
OH2BMN	VOIMASSA	
OH2BMO	VOIMASSA	
OH2BMP	VOIMASSA	
OH2BMQ	VOIMASSA	
OH2BMS	VOIMASSA	
OH2BMU	VOIMASSA	
OH2BMV	VOIMASSA	
OH2BMW	VOIMASSA	
OH2BMX	VOIMASSA	
OH2BMY	VOIMASSA	
OH2BN	VOIMASSA	
OH2BNA	VOIMASSA	
OH2BND	VOIMASSA	
OH2BNE	VOIMASSA	
OH2BNF	VOIMASSA	
OH2BNG	VOIMASSA	
OH2BNH	VOIMASSA	
OH2BNI	VOIMASSA	
OH2BNJ	VOIMASSA	
OH2BNM	VOIMASSA	
OH2BNN	VOIMASSA	
OH2BNP	VOIMASSA	
OH2BNQ	VOIMASSA	
OH2BNS	VOIMASSA	
OH2BNU	VOIMASSA	
OH2BNW	VOIMASSA	
OH2BNX	VOIMASSA	
OH2BO	VOIMASSA	
OH2BOE	VOIMASSA	
OH2BOK	VOIMASSA	
OH2BON	VOIMASSA	
OH2BOQ	VOIMASSA	
OH2BOT	VOIMASSA	
OH2BOW	VOIMASSA	
OH2BOX	VOIMASSA	
OH2BOZ	VOIMASSA	
OH2BP	VOIMASSA	
OH2BPB	VOIMASSA	
OH2BPC	VOIMASSA	
OH2BPF	VOIMASSA	
OH2BPI	VOIMASSA	
OH2BPJ	VOIMASSA	
OH2BPM	VOIMASSA	
OH2BPN	VOIMASSA	
OH2BPO	VOIMASSA	
OH2BPS	VOIMASSA	
OH2BPT	VOIMASSA	
OH2BPU	VOIMASSA	
OH2BPW	VOIMASSA	
OH2BQ	VOIMASSA	
OH2BQB	VOIMASSA	
OH2BQE	VOIMASSA	
OH2BQF	VOIMASSA	
OH2BQG	VOIMASSA	
OH2BQI	VOIMASSA	
OH2BQM	VOIMASSA	
OH2BQO	VOIMASSA	
OH2BQP	VOIMASSA	
OH2BQQ	VOIMASSA	
OH2BQS	VOIMASSA	
OH2BQT	VOIMASSA	
OH2BQU	VOIMASSA	
OH2BQW	VOIMASSA	
OH2BQY	VOIMASSA	
OH2BQZ	VOIMASSA	
OH2BR	VOIMASSA	
OH2BRA	VOIMASSA	
OH2BRD	VOIMASSA	
OH2BRE	VOIMASSA	
OH2BRF	VOIMASSA	
OH2BRG	VOIMASSA	
OH2BRH	VOIMASSA	
OH2BRL	VOIMASSA	
OH2BRN	VOIMASSA	
OH2BRP	VOIMASSA	
OH2BRR	VOIMASSA	
OH2BRT	VOIMASSA	
OH2BRX	VOIMASSA	
OH2BRY	VOIMASSA	
OH2BRZ	VOIMASSA	
OH2BS	VOIMASSA	
OH2BSA	VOIMASSA	
OH2BSC	VOIMASSA	
OH2BSE	VOIMASSA	
OH2BSF	VOIMASSA	
OH2BSH	VOIMASSA	
OH2BSI	VOIMASSA	
OH2BSP	VOIMASSA	
OH2BSQ	VOIMASSA	
OH2BSR	VOIMASSA	
OH2BSV	VOIMASSA	
OH2BSX	VOIMASSA	
OH2BSY	VOIMASSA	
OH2BT	VOIMASSA	
OH2BTA	VOIMASSA	
OH2BTB	VOIMASSA	
OH2BTD	VOIMASSA	
OH2BTE	VOIMASSA	
OH2BTG	VOIMASSA	
OH2BTH	VOIMASSA	
OH2BTI	VOIMASSA	
OH2BTJ	VOIMASSA	
OH2BTL	VOIMASSA	
OH2BTM	VOIMASSA	
OH2BTQ	VOIMASSA	
OH2BTT	VOIMASSA	
OH2BTU	VOIMASSA	
OH2BTX	VOIMASSA	
OH2BTY	VOIMASSA	
OH2BTZ	VOIMASSA	
OH2BU	VOIMASSA	
OH2BUA	VOIMASSA	
OH2BUB	VOIMASSA	
OH2BUC	VOIMASSA	
OH2BUE	VOIMASSA	
OH2BUF	VOIMASSA	
OH2BUG	VOIMASSA	
OH2BUH	VOIMASSA	
OH2BUT	VOIMASSA	
OH2BUU	VOIMASSA	
OH2BUW	VOIMASSA	
OH2BUZ	VOIMASSA	
OH2BV	VOIMASSA	
OH2BW	KARENSSI	
OH2BWA	VOIMASSA	
OH2BVB	VOIMASSA	
OH2BVE	VOIMASSA	
OH2BVG	VOIMASSA	
OH2BVH	VOIMASSA	
OH2BVI	VOIMASSA	
OH2BVK	VOIMASSA	
OH2BVL	VOIMASSA	
OH2BVM	VOIMASSA	
OH2BWP	VOIMASSA	
OH2BVT	VOIMASSA	
OH2BVU	VOIMASSA	
OH2BWU	VOIMASSA	
OH2BVW	VOIMASSA	
OH2BWV	VOIMASSA	
OH2BWW	VOIMASSA	
OH2BWX	VOIMASSA	
OH2BVZ	VOIMASSA	
OH2BWZ	VOIMASSA	
OH2BX	KARENSSI	
OH2BXG	VOIMASSA	
OH2BXI	VOIMASSA	
OH2BXJ	VOIMASSA	
OH2BXK	VOIMASSA	
OH2BXM	VOIMASSA	
OH2BXN	VOIMASSA	
OH2BXO	VOIMASSA	
OH2BXP	VOIMASSA	
OH2BXR	VOIMASSA	
OH2BXS	VOIMASSA	
OH2BXT	VOIMASSA	
OH2BXV	VOIMASSA	
OH2BXX	VOIMASSA	
OH2BY	VOIMASSA	
OH2BYB	VOIMASSA	
OH2BYC	VOIMASSA	
OH2BYD	VOIMASSA	
OH2BYE	VOIMASSA	
OH2BYG	VOIMASSA	
OH2BYH	VOIMASSA	
OH2BYJ	VOIMASSA	
OH2BYL	VOIMASSA	
OH2BYO	VOIMASSA	
OH2BYP	VOIMASSA	
OH2BYQ	VOIMASSA	
OH2BYS	VOIMASSA	
OH2BYU	VOIMASSA	
OH2BYX	VOIMASSA	
OH2BYY	VOIMASSA	
OH2BZ	VOIMASSA	
OH2BZD	VOIMASSA	
OH2BZF	VOIMASSA	
OH2BZG	VOIMASSA	
OH2BZJ	VOIMASSA	
OH2BZM	VOIMASSA	
OH2BZP	VOIMASSA	
OH2BZQ	VOIMASSA	
OH2BZY	VOIMASSA	
OH2C	VOIMASSA	
OH2CAE	VOIMASSA	
OH2CAF	VOIMASSA	
OH2CAG	VOIMASSA	
OH2CAM	VOIMASSA	
OH2CAT	VOIMASSA	
OH2CAV	VOIMASSA	
OH2CB	VOIMASSA	
OH2CBD	VOIMASSA	
OH2CBE	VOIMASSA	
OH2CBF	VOIMASSA	
OH2CBH	VOIMASSA	
OH2CBP	VOIMASSA	
OH2CBQ	VOIMASSA	
OH2CC	VOIMASSA	
OH2CCD	VOIMASSA	
OH2CCN	VOIMASSA	
OH2CDA	VOIMASSA	
OH2CDB	VOIMASSA	
OH2CDG	VOIMASSA	
OH2CDX	VOIMASSA	
OH2CDZ	VOIMASSA	
OH2CEA	VOIMASSA	
OH2CED	VOIMASSA	
OH2CEM	VOIMASSA	
OH2CEQ	VOIMASSA	
OH2CF	VOIMASSA	
OH2CFA	VOIMASSA	
OH2CFB	VOIMASSA	
OH2CFC	VOIMASSA	
OH2CFE	VOIMASSA	
OH2CFS	VOIMASSA	
OH2CFY	VOIMASSA	
OH2CFZ	VOIMASSA	
OH2CG	VOIMASSA	
OH2CGN	VOIMASSA	
OH2CGQ	VOIMASSA	
OH2CGR	VOIMASSA	
OH2CGS	VOIMASSA	
OH2CGU	VOIMASSA	
OH2CGZ	VOIMASSA	
OH2CH	VOIMASSA	
OH2CHB	VOIMASSA	
OH2CHC	VOIMASSA	
OH2CHD	VOIMASSA	
OH2CHF	VOIMASSA	
OH2CI	VOIMASSA	
OH2CJ	VOIMASSA	
OH2CK	VOIMASSA	
OH2CL	KARENSSI	
OH2CM	VOIMASSA	
OH2CN	VOIMASSA	
OH2CNC	VOIMASSA	
OH2COOL	VOIMASSA	
OH2CP	VOIMASSA	
OH2CQ	VOIMASSA	
OH2CT	VOIMASSA	
OH2CV	VOIMASSA	
OH2CW	VOIMASSA	
OH2CX	VOIMASSA	
OH2D	VOIMASSA	
OH2DA	VOIMASSA	
OH2DB	VOIMASSA	
OH2DC	VOIMASSA	
OH2DD	VOIMASSA	
OH2DF	VOIMASSA	
OH2DG	VOIMASSA	
OH2DIGI	VOIMASSA	
OH2DJ	VOIMASSA	
OH2DK	VOIMASSA	
OH2DL	VOIMASSA	
OH2DM	VOIMASSA	
OH2DMR	VOIMASSA	
OH2DMRA	VOIMASSA	
OH2DMRE	VOIMASSA	
OH2DMRH	VOIMASSA	
OH2DMRL	VOIMASSA	
OH2DMRN	VOIMASSA	
OH2DMRR	VOIMASSA	
OH2DN	KARENSSI	
OH2DO	VOIMASSA	
OH2DT	VOIMASSA	
OH2DU	VOIMASSA	
OH2DV	VOIMASSA	
OH2DW	VOIMASSA	
OH2DX	VOIMASSA	
OH2DXF	VOIMASSA	
OH2DY	VOIMASSA	
OH2DZ	VOIMASSA	
OH2E	VOIMASSA	
OH2EA	VOIMASSA	
OH2EAF	VOIMASSA	
OH2EAM	VOIMASSA	
OH2EAN	VOIMASSA	
OH2EAO	VOIMASSA	
OH2EAP	VOIMASSA	
OH2EAQ	VOIMASSA	
OH2EAS	VOIMASSA	
OH2EAT	VOIMASSA	
OH2EBV	VOIMASSA	
OH2EBW	VOIMASSA	
OH2EC	KARENSSI	
OH2ECG	VOIMASSA	
OH2EDA	VOIMASSA	
OH2EDB	VOIMASSA	
OH2EDC	VOIMASSA	
OH2EDE	VOIMASSA	
OH2EDF	VOIMASSA	
OH2EDH	VOIMASSA	
OH2EDI	VOIMASSA	
OH2EDV	VOIMASSA	
OH2EE	VOIMASSA	
OH2EED	VOIMASSA	
OH2EEE	VOIMASSA	
OH2EF	VOIMASSA	
OH2EFC	VOIMASSA	
OH2EFD	VOIMASSA	
OH2EFS	VOIMASSA	
OH2EGI	VOIMASSA	
OH2EGN	VOIMASSA	
OH2EGO	VOIMASSA	
OH2EGP	VOIMASSA	
OH2EGQ	VOIMASSA	
OH2EGW	VOIMASSA	
OH2EGZ	VOIMASSA	
OH2EH	VOIMASSA	
OH2EHG	VOIMASSA	
OH2EHK	VOIMASSA	
OH2EHW	VOIMASSA	
OH2EIA	VOIMASSA	
OH2EIB	VOIMASSA	
OH2EIC	VOIMASSA	
OH2EIE	VOIMASSA	
OH2EII	VOIMASSA	
OH2EIQ	VOIMASSA	
OH2EIR	VOIMASSA	
OH2EIW	VOIMASSA	
OH2EJC	VOIMASSA	
OH2EJK	KARENSSI	
OH2EJR	VOIMASSA	
OH2EJU	VOIMASSA	
OH2EK	VOIMASSA	
OH2EKB	VOIMASSA	
OH2EKG	VOIMASSA	
OH2EKI	VOIMASSA	
OH2EKK	VOIMASSA	
OH2EKO	VOIMASSA	
OH2EKY	VOIMASSA	
OH2ELI	VOIMASSA	
OH2ELR	VOIMASSA	
OH2EM	VOIMASSA	
OH2EME	VOIMASSA	
OH2EMF	VOIMASSA	
OH2EMG	VOIMASSA	
OH2EMJ	VOIMASSA	
OH2EMK	VOIMASSA	
OH2EMP	VOIMASSA	
OH2EMQ	VOIMASSA	
OH2EMT	VOIMASSA	
OH2ENF	VOIMASSA	
OH2ENG	VOIMASSA	
OH2ENN	VOIMASSA	
OH2ENP	VOIMASSA	
OH2ENR	VOIMASSA	
OH2ENW	VOIMASSA	
OH2ENZ	VOIMASSA	
OH2EO	VOIMASSA	
OH2EOP	VOIMASSA	
OH2EOU	VOIMASSA	
OH2EP	VOIMASSA	
OH2EPF	VOIMASSA	
OH2EPH	VOIMASSA	
OH2EPI	VOIMASSA	
OH2EPK	VOIMASSA	
OH2EPN	VOIMASSA	
OH2EPP	VOIMASSA	
OH2EPQ	VOIMASSA	
OH2EPS	VOIMASSA	
OH2EPU	VOIMASSA	
OH2EPW	VOIMASSA	
OH2EQF	VOIMASSA	
OH2EQG	VOIMASSA	
OH2EQJ	VOIMASSA	
OH2EQK	VOIMASSA	
OH2EQL	VOIMASSA	
OH2EQU	VOIMASSA	
OH2EQZ	VOIMASSA	
OH2ER	VOIMASSA	
OH2ERA	VOIMASSA	
OH2ERG	VOIMASSA	
OH2ERH	VOIMASSA	
OH2ERJ	VOIMASSA	
OH2ERK	VOIMASSA	
OH2ERM	VOIMASSA	
OH2ESA	VOIMASSA	
OH2ESP	VOIMASSA	
OH2ESR	VOIMASSA	
OH2ESS	VOIMASSA	
OH2EST	VOIMASSA	
OH2ET	VOIMASSA	
OH2ETE	VOIMASSA	
OH2ETM	VOIMASSA	
OH2ETN	VOIMASSA	
OH2ETW	VOIMASSA	
OH2EUG	VOIMASSA	
OH2EUH	VOIMASSA	
OH2EUP	VOIMASSA	
OH2EUQ	VOIMASSA	
OH2EUU	VOIMASSA	
OH2EUV	VOIMASSA	
OH2EUX	VOIMASSA	
OH2EUZ	VOIMASSA	
OH2EV	VOIMASSA	
OH2EVF	VOIMASSA	
OH2EWG	VOIMASSA	
OH2EWH	VOIMASSA	
OH2EWI	VOIMASSA	
OH2EWJ	VOIMASSA	
OH2EWK	VOIMASSA	
OH2EWL	VOIMASSA	
OH2EWN	VOIMASSA	
OH2EWO	VOIMASSA	
OH2EWT	VOIMASSA	
OH2EWW	VOIMASSA	
OH2EWX	VOIMASSA	
OH2EVY	VOIMASSA	
OH2EVZ	VOIMASSA	
OH2EX	VOIMASSA	
OH2EXE	VOIMASSA	
OH2EXJ	VOIMASSA	
OH2EXK	VOIMASSA	
OH2EXL	VOIMASSA	
OH2EXU	VOIMASSA	
OH2EY	VOIMASSA	
OH2EYS	VOIMASSA	
OH2EYX	VOIMASSA	
OH2EYY	VOIMASSA	
OH2EZ	VOIMASSA	
OH2EZE	VOIMASSA	
OH2EZG	VOIMASSA	
OH2EZL	VOIMASSA	
OH2EZM	VOIMASSA	
OH2EZR	VOIMASSA	
OH2F	VOIMASSA	
OH2FAK	VOIMASSA	
OH2FB	VOIMASSA	
OH2FBJ	VOIMASSA	
OH2FBQ	VOIMASSA	
OH2FBX	VOIMASSA	
OH2FCE	VOIMASSA	
OH2FCH	VOIMASSA	
OH2FCZ	VOIMASSA	
OH2FDA	VOIMASSA	
OH2FDF	VOIMASSA	
OH2FDG	VOIMASSA	
OH2FDH	VOIMASSA	
OH2FDI	VOIMASSA	
OH2FDL	VOIMASSA	
OH2FDQ	VOIMASSA	
OH2FDS	VOIMASSA	
OH2FE	VOIMASSA	
OH2FEE	VOIMASSA	
OH2FEG	VOIMASSA	
OH2FET	VOIMASSA	
OH2FEW	VOIMASSA	
OH2FFO	VOIMASSA	
OH2FFP	VOIMASSA	
OH2FFU	VOIMASSA	
OH2FFW	VOIMASSA	
OH2FGJ	VOIMASSA	
OH2FH	VOIMASSA	
OH2FHF	VOIMASSA	
OH2FHI	VOIMASSA	
OH2FHJ	VOIMASSA	
OH2FHN	VOIMASSA	
OH2FHO	VOIMASSA	
OH2FI	KARENSSI	
OH2FIA	VOIMASSA	
OH2FIB	VOIMASSA	
OH2FIH	VOIMASSA	
OH2FIK	VOIMASSA	
OH2FIZ	VOIMASSA	
OH2FJ	VOIMASSA	
OH2FJU	VOIMASSA	
OH2FKX	VOIMASSA	
OH2FKZ	VOIMASSA	
OH2FLI	VOIMASSA	
OH2FLJ	VOIMASSA	
OH2FLM	VOIMASSA	
OH2FLO	VOIMASSA	
OH2FLQ	VOIMASSA	
OH2FLV	VOIMASSA	
OH2FLW	VOIMASSA	
OH2FM	VOIMASSA	
OH2FMB	VOIMASSA	
OH2FMC	VOIMASSA	
OH2FMD	VOIMASSA	
OH2FMN	VOIMASSA	
OH2FMR	VOIMASSA	
OH2FNE	VOIMASSA	
OH2FNR	VOIMASSA	
OH2FNX	VOIMASSA	
OH2FOJ	VOIMASSA	
OH2FOM	VOIMASSA	
OH2FOO	VOIMASSA	
OH2FOP	VOIMASSA	
OH2FOT	VOIMASSA	
OH2FOUR	VOIMASSA	
OH2FP	VOIMASSA	
OH2FPE	VOIMASSA	
OH2FPF	VOIMASSA	
OH2FPG	VOIMASSA	
OH2FPI	VOIMASSA	
OH2FPJ	VOIMASSA	
OH2FPK	VOIMASSA	
OH2FPL	VOIMASSA	
OH2FPN	VOIMASSA	
OH2FPP	VOIMASSA	
OH2FPR	VOIMASSA	
OH2FPS	VOIMASSA	
OH2FQE	VOIMASSA	
OH2FQF	VOIMASSA	
OH2FQK	VOIMASSA	
OH2FQM	VOIMASSA	
OH2FQV	VOIMASSA	
OH2FR	VOIMASSA	
OH2FRD	VOIMASSA	
OH2FRE	VOIMASSA	
OH2FRF	VOIMASSA	
OH2FRG	VOIMASSA	
OH2FRM	VOIMASSA	
OH2FRU	VOIMASSA	
OH2FRV	VOIMASSA	
OH2FRW	VOIMASSA	
OH2FS	VOIMASSA	
OH2FSA	VOIMASSA	
OH2FSB	VOIMASSA	
OH2FSJ	VOIMASSA	
OH2FT	VOIMASSA	
OH2FTA	VOIMASSA	
OH2FTB	VOIMASSA	
OH2FTG	VOIMASSA	
OH2FTJ	VOIMASSA	
OH2FTO	VOIMASSA	
OH2FTP	VOIMASSA	
OH2FTS	VOIMASSA	
OH2FTU	VOIMASSA	
OH2FTX	VOIMASSA	
OH2FU	VOIMASSA	
OH2FUI	VOIMASSA	
OH2FUJ	VOIMASSA	
OH2FUK	VOIMASSA	
OH2FUM	VOIMASSA	
OH2FUP	VOIMASSA	
OH2FUQ	VOIMASSA	
OH2FUR	VOIMASSA	
OH2FUT	VOIMASSA	
OH2FUW	VOIMASSA	
OH2FUZ	VOIMASSA	
OH2FVH	VOIMASSA	
OH2FVI	VOIMASSA	
OH2FWK	VOIMASSA	
OH2FVL	VOIMASSA	
OH2FWS	VOIMASSA	
OH2FWT	VOIMASSA	
OH2FXD	VOIMASSA	
OH2FXI	VOIMASSA	
OH2FXJ	VOIMASSA	
OH2FXN	VOIMASSA	
OH2FXR	VOIMASSA	
OH2FXS	VOIMASSA	
OH2FXT	VOIMASSA	
OH2FY	VOIMASSA	
OH2FYM	VOIMASSA	
OH2FZ	VOIMASSA	
OH2FZH	VOIMASSA	
OH2FZO	VOIMASSA	
OH2FZS	VOIMASSA	
OH2FZV	VOIMASSA	
OH2G	VOIMASSA	
OH2GAH	VOIMASSA	
OH2GAQ	VOIMASSA	
OH2GAT	VOIMASSA	
OH2GAU	VOIMASSA	
OH2GAV	VOIMASSA	
OH2GAX	VOIMASSA	
OH2GB	VOIMASSA	
OH2GBA	VOIMASSA	
OH2GBJ	VOIMASSA	
OH2GC	VOIMASSA	
OH2GCK	VOIMASSA	
OH2GCM	VOIMASSA	
OH2GCQ	VOIMASSA	
OH2GD	VOIMASSA	
OH2GDE	VOIMASSA	
OH2GDF	VOIMASSA	
OH2GDJ	VOIMASSA	
OH2GEC	VOIMASSA	
OH2GEK	VOIMASSA	
OH2GER	VOIMASSA	
OH2GEX	VOIMASSA	
OH2GEZ	VOIMASSA	
OH2GF	VOIMASSA	
OH2GFC	VOIMASSA	
OH2GFY	VOIMASSA	
OH2GG	VOIMASSA	
OH2GGN	VOIMASSA	
OH2GGS	VOIMASSA	
OH2GGZ	VOIMASSA	
OH2GHQ	VOIMASSA	
OH2GHS	VOIMASSA	
OH2GHZ	VOIMASSA	
OH2GI	VOIMASSA	
OH2GIK	VOIMASSA	
OH2GIL	VOIMASSA	
OH2GIP	VOIMASSA	
OH2GIZ	VOIMASSA	
OH2GJ	VOIMASSA	
OH2GJI	VOIMASSA	
OH2GJK	VOIMASSA	
OH2GJL	VOIMASSA	
OH2GJY	VOIMASSA	
OH2GKQ	VOIMASSA	
OH2GKR	VOIMASSA	
OH2GLA	VOIMASSA	
OH2GLB	VOIMASSA	
OH2GLD	VOIMASSA	
OH2GLG	VOIMASSA	
OH2GLH	VOIMASSA	
OH2GLJ	VOIMASSA	
OH2GLK	VOIMASSA	
OH2GLP	VOIMASSA	
OH2GLR	VOIMASSA	
OH2GLT	VOIMASSA	
OH2GM	KARENSSI	
OH2GMF	VOIMASSA	
OH2GMH	VOIMASSA	
OH2GMJ	VOIMASSA	
OH2GMK	VOIMASSA	
OH2GN	VOIMASSA	
OH2GNB	VOIMASSA	
OH2GNE	VOIMASSA	
OH2GOA	VOIMASSA	
OH2GOL	VOIMASSA	
OH2GOO	VOIMASSA	
OH2GP	VOIMASSA	
OH2GPO	VOIMASSA	
OH2GQC	VOIMASSA	
OH2GQK	VOIMASSA	
OH2GQN	VOIMASSA	
OH2GQO	VOIMASSA	
OH2GQV	VOIMASSA	
OH2GQW	VOIMASSA	
OH2GQX	VOIMASSA	
OH2GQY	VOIMASSA	
OH2GRK	VOIMASSA	
OH2GRS	VOIMASSA	
OH2GSC	VOIMASSA	
OH2GSP	VOIMASSA	
OH2GSY	VOIMASSA	
OH2GTC	VOIMASSA	
OH2GTK	VOIMASSA	
OH2GTM	VOIMASSA	
OH2GTQ	VOIMASSA	
OH2GTS	VOIMASSA	
OH2GTY	VOIMASSA	
OH2GTZ	VOIMASSA	
OH2GU	VOIMASSA	
OH2GUB	VOIMASSA	
OH2GUC	VOIMASSA	
OH2GUG	VOIMASSA	
OH2GUS	VOIMASSA	
OH2GV	VOIMASSA	
OH2GVA	VOIMASSA	
OH2GVB	VOIMASSA	
OH2GVD	VOIMASSA	
OH2GWD	VOIMASSA	
OH2GVE	VOIMASSA	
OH2GWE	VOIMASSA	
OH2GVG	VOIMASSA	
OH2GWG	VOIMASSA	
OH2GVV	VOIMASSA	
OH2GVY	VOIMASSA	
OH2GWZ	VOIMASSA	
OH2GX	VOIMASSA	
OH2GXE	VOIMASSA	
OH2GXH	VOIMASSA	
OH2GXK	VOIMASSA	
OH2GXL	VOIMASSA	
OH2GXM	VOIMASSA	
OH2GXN	VOIMASSA	
OH2GXP	VOIMASSA	
OH2GXT	VOIMASSA	
OH2GXV	VOIMASSA	
OH2GXX	VOIMASSA	
OH2GYS	VOIMASSA	
OH2GYT	VOIMASSA	
OH2GYX	VOIMASSA	
OH2GZ	VOIMASSA	
OH2GZH	VOIMASSA	
OH2GZK	VOIMASSA	
OH2GZS	VOIMASSA	
OH2GZV	VOIMASSA	
OH2GZX	VOIMASSA	
OH2H	VOIMASSA	
OH2HA	VOIMASSA	
OH2HAI	VOIMASSA	
OH2HAL	VOIMASSA	
OH2HAN	VOIMASSA	
OH2HBK	VOIMASSA	
OH2HBZ	VOIMASSA	
OH2HCB	VOIMASSA	
OH2HCR	VOIMASSA	
OH2HCS	VOIMASSA	
OH2HCT	VOIMASSA	
OH2HCU	VOIMASSA	
OH2HCX	VOIMASSA	
OH2HCY	VOIMASSA	
OH2HCZ	VOIMASSA	
OH2HDF	VOIMASSA	
OH2HDP	VOIMASSA	
OH2HDV	VOIMASSA	
OH2HE	VOIMASSA	
OH2HEJ	VOIMASSA	
OH2HEM	VOIMASSA	
OH2HESI	VOIMASSA	
OH2HEW	VOIMASSA	
OH2HEX	VOIMASSA	
OH2HFB	VOIMASSA	
OH2HFE	VOIMASSA	
OH2HFG	VOIMASSA	
OH2HGF	VOIMASSA	
OH2HGK	VOIMASSA	
OH2HGL	VOIMASSA	
OH2HGS	VOIMASSA	
OH2HH	VOIMASSA	
OH2HHC	VOIMASSA	
OH2HHV	VOIMASSA	
OH2HHW	VOIMASSA	
OH2HI	VOIMASSA	
OH2HIC	VOIMASSA	
OH2HIL	VOIMASSA	
OH2HIM	VOIMASSA	
OH2HIZ	VOIMASSA	
OH2HJ	VOIMASSA	
OH2HJA	VOIMASSA	
OH2HJD	VOIMASSA	
OH2HJL	VOIMASSA	
OH2HJV	VOIMASSA	
OH2HK	VOIMASSA	
OH2HKB	VOIMASSA	
OH2HKE	VOIMASSA	
OH2HKZ	VOIMASSA	
OH2HL	VOIMASSA	
OH2HLE	VOIMASSA	
OH2HLF	VOIMASSA	
OH2HLP	VOIMASSA	
OH2HM	VOIMASSA	
OH2HMB	VOIMASSA	
OH2HME	VOIMASSA	
OH2HMZ	VOIMASSA	
OH2HN	VOIMASSA	
OH2HND	VOIMASSA	
OH2HNF	VOIMASSA	
OH2HNV	VOIMASSA	
OH2HNW	VOIMASSA	
OH2HO	VOIMASSA	
OH2HOD	VOIMASSA	
OH2HOE	VOIMASSA	
OH2HOH	VOIMASSA	
OH2HOJ	VOIMASSA	
OH2HON	VOIMASSA	
OH2HOR	VOIMASSA	
OH2HOT	VOIMASSA	
OH2HP	VOIMASSA	
OH2HPJ	VOIMASSA	
OH2HPO	VOIMASSA	
OH2HPR	VOIMASSA	
OH2HPX	VOIMASSA	
OH2HQ	VOIMASSA	
OH2HQC	VOIMASSA	
OH2HQE	VOIMASSA	
OH2HQP	VOIMASSA	
OH2HQS	VOIMASSA	
OH2HQU	VOIMASSA	
OH2HRD	VOIMASSA	
OH2HRP	VOIMASSA	
OH2HRS	VOIMASSA	
OH2HRT	VOIMASSA	
OH2HRU	VOIMASSA	
OH2HSE	VOIMASSA	
OH2HSG	VOIMASSA	
OH2HSI	VOIMASSA	
OH2HSJ	VOIMASSA	
OH2HSK	VOIMASSA	
OH2HSP	VOIMASSA	
OH2HSS	VOIMASSA	
OH2HSW	VOIMASSA	
OH2HT	VOIMASSA	
OH2HTA	VOIMASSA	
OH2HTF	VOIMASSA	
OH2HTJ	VOIMASSA	
OH2HTN	VOIMASSA	
OH2HTX	VOIMASSA	
OH2HU	VOIMASSA	
OH2HUA	VOIMASSA	
OH2HUH	VOIMASSA	
OH2HUI	VOIMASSA	
OH2HUJ	VOIMASSA	
OH2HUM	VOIMASSA	
OH2HUU	VOIMASSA	
OH2HWH	VOIMASSA	
OH2HVJ	VOIMASSA	
OH2HVV	VOIMASSA	
OH2HXC	VOIMASSA	
OH2HXI	VOIMASSA	
OH2HXO	VOIMASSA	
OH2HXP	VOIMASSA	
OH2HXQ	VOIMASSA	
OH2HXR	VOIMASSA	
OH2HXT	VOIMASSA	
OH2HXY	VOIMASSA	
OH2HXZ	VOIMASSA	
OH2HYM	VOIMASSA	
OH2HYT	VOIMASSA	
OH2HZ	VOIMASSA	
OH2HZA	VOIMASSA	
OH2HZG	VOIMASSA	
OH2HZL	VOIMASSA	
OH2IA	VOIMASSA	
OH2IC	VOIMASSA	
OH2ID	VOIMASSA	
OH2IG	VOIMASSA	
OH2IGU	VOIMASSA	
OH2II	VOIMASSA	
OH2IJ	VOIMASSA	
OH2IK	VOIMASSA	
OH2IN	VOIMASSA	
OH2IO	VOIMASSA	
OH2IPA	VOIMASSA	
OH2IS	VOIMASSA	
OH2IT	VOIMASSA	
OH2IV	VOIMASSA	
OH2IW	VOIMASSA	
OH2IZ	VOIMASSA	
OH2J	VOIMASSA	
OH2JA	VOIMASSA	
OH2JAF	VOIMASSA	
OH2JAL	VOIMASSA	
OH2JAM	VOIMASSA	
OH2JARI	VOIMASSA	
OH2JB	VOIMASSA	
OH2JBA	VOIMASSA	
OH2JBE	VOIMASSA	
OH2JBK	VOIMASSA	
OH2JBQ	VOIMASSA	
OH2JBZ	VOIMASSA	
OH2JC	VOIMASSA	
OH2JCP	VOIMASSA	
OH2JCW	VOIMASSA	
OH2JE	VOIMASSA	
OH2JEC	VOIMASSA	
OH2JED	VOIMASSA	
OH2JEE	VOIMASSA	
OH2JF	VOIMASSA	
OH2JFA	VOIMASSA	
OH2JFX	VOIMASSA	
OH2JG	VOIMASSA	
OH2JH	VOIMASSA	
OH2JI	VOIMASSA	
OH2JIA	VOIMASSA	
OH2JIM	VOIMASSA	
OH2JIN	VOIMASSA	
OH2JIU	VOIMASSA	
OH2JIZ	VOIMASSA	
OH2JJ	VOIMASSA	
OH2JJN	VOIMASSA	
OH2JJP	VOIMASSA	
OH2JKF	VOIMASSA	
OH2JKR	VOIMASSA	
OH2JKU	VOIMASSA	
OH2JL	VOIMASSA	
OH2JLH	VOIMASSA	
OH2JLI	VOIMASSA	
OH2JLJ	VOIMASSA	
OH2JLN	VOIMASSA	
OH2JM	VOIMASSA	
OH2JMF	VOIMASSA	
OH2JMG	VOIMASSA	
OH2JNA	VOIMASSA	
OH2JNC	VOIMASSA	
OH2JNE	VOIMASSA	
OH2JNF	VOIMASSA	
OH2JNJ	VOIMASSA	
OH2JNO	VOIMASSA	
OH2JNS	VOIMASSA	
OH2JNY	VOIMASSA	
OH2JO	VOIMASSA	
OH2JP	VOIMASSA	
OH2JPF	VOIMASSA	
OH2JPR	VOIMASSA	
OH2JQL	VOIMASSA	
OH2JQS	VOIMASSA	
OH2JR	VOIMASSA	
OH2JRB	VOIMASSA	
OH2JRD	VOIMASSA	
OH2JRJ	VOIMASSA	
OH2JRP	VOIMASSA	
OH2JRR	VOIMASSA	
OH2JRY	VOIMASSA	
OH2JS	VOIMASSA	
OH2JSD	VOIMASSA	
OH2JSE	VOIMASSA	
OH2JSG	VOIMASSA	
OH2JSP	VOIMASSA	
OH2JSQ	VOIMASSA	
OH2JSR	VOIMASSA	
OH2JSV	VOIMASSA	
OH2JT	VOIMASSA	
OH2JTE	VOIMASSA	
OH2JTF	VOIMASSA	
OH2JU	VOIMASSA	
OH2JUI	VOIMASSA	
OH2JUZ	VOIMASSA	
OH2JV	VOIMASSA	
OH2JW	VOIMASSA	
OH2JVA	VOIMASSA	
OH2JVN	VOIMASSA	
OH2JWR	VOIMASSA	
OH2JWU	VOIMASSA	
OH2JXA	VOIMASSA	
OH2JXE	VOIMASSA	
OH2JXG	VOIMASSA	
OH2JXI	VOIMASSA	
OH2JXN	VOIMASSA	
OH2JXU	VOIMASSA	
OH2JXV	VOIMASSA	
OH2JYT	VOIMASSA	
OH2JZ	VOIMASSA	
OH2JZD	VOIMASSA	
OH2JZO	VOIMASSA	
OH2JZV	VOIMASSA	
OH2JZW	VOIMASSA	
OH2JZX	VOIMASSA	
OH2K	VOIMASSA	
OH2KA	VOIMASSA	
OH2KAB	VOIMASSA	
OH2KAD	VOIMASSA	
OH2KBJ	VOIMASSA	
OH2KBR	VOIMASSA	
OH2KC	VOIMASSA	
OH2KCG	VOIMASSA	
OH2KCR	VOIMASSA	
OH2KCS	VOIMASSA	
OH2KD	VOIMASSA	
OH2KEA	VOIMASSA	
OH2KEM	VOIMASSA	
OH2KEN	VOIMASSA	
OH2KF	VOIMASSA	
OH2KFB	VOIMASSA	
OH2KFD	VOIMASSA	
OH2KFI	VOIMASSA	
OH2KFM	VOIMASSA	
OH2KFO	VOIMASSA	
OH2KFU	VOIMASSA	
OH2KFX	VOIMASSA	
OH2KGU	VOIMASSA	
OH2KGY	VOIMASSA	
OH2KH	VOIMASSA	
OH2KHJ	VOIMASSA	
OH2KHX	VOIMASSA	
OH2KHZ	VOIMASSA	
OH2KI	VOIMASSA	
OH2KIF	VOIMASSA	
OH2KJ	VOIMASSA	
OH2KJG	VOIMASSA	
OH2KK	VOIMASSA	
OH2KKL	VOIMASSA	
OH2KKO	VOIMASSA	
OH2KKP	VOIMASSA	
OH2KKQ	VOIMASSA	
OH2KKS	VOIMASSA	
OH2KKU	VOIMASSA	
OH2KKV	VOIMASSA	
OH2KKX	VOIMASSA	
OH2KL	VOIMASSA	
OH2KLN	VOIMASSA	
OH2KLY	VOIMASSA	
OH2KM	VOIMASSA	
OH2KMA	VOIMASSA	
OH2KME	VOIMASSA	
OH2KMK	VOIMASSA	
OH2KML	VOIMASSA	
OH2KMM	VOIMASSA	
OH2KMO	VOIMASSA	
OH2KMS	VOIMASSA	
OH2KMT	VOIMASSA	
OH2KMU	VOIMASSA	
OH2KMV	VOIMASSA	
OH2KMW	VOIMASSA	
OH2KNA	VOIMASSA	
OH2KNF	VOIMASSA	
OH2KNI	VOIMASSA	
OH2KNS	VOIMASSA	
OH2KNU	VOIMASSA	
OH2KO	VOIMASSA	
OH2KOJ	VOIMASSA	
OH2KP	VOIMASSA	
OH2KPE	VOIMASSA	
OH2KPO	VOIMASSA	
OH2KPP	VOIMASSA	
OH2KPT	VOIMASSA	
OH2KPW	VOIMASSA	
OH2KQF	VOIMASSA	
OH2KR	VOIMASSA	
OH2KS	VOIMASSA	
OH2KSK	VOIMASSA	
OH2KSL	VOIMASSA	
OH2KSM	VOIMASSA	
OH2KSQ	VOIMASSA	
OH2KT	VOIMASSA	
OH2KTB	VOIMASSA	
OH2KTG	VOIMASSA	
OH2KTH	VOIMASSA	
OH2KTJ	VOIMASSA	
OH2KTU	VOIMASSA	
OH2KTV	VOIMASSA	
OH2KU	VOIMASSA	
OH2KUF	VOIMASSA	
OH2KUQ	VOIMASSA	
OH2KW	VOIMASSA	
OH2KWJ	VOIMASSA	
OH2KVL	VOIMASSA	
OH2KWO	VOIMASSA	
OH2KWY	VOIMASSA	
OH2KXA	VOIMASSA	
OH2KXD	VOIMASSA	
OH2KXN	VOIMASSA	
OH2KXS	VOIMASSA	
OH2KYW	VOIMASSA	
OH2KZ	VOIMASSA	
OH2KZE	VOIMASSA	
OH2KZF	VOIMASSA	
OH2KZG	VOIMASSA	
OH2KZK	VOIMASSA	
OH2LA	VOIMASSA	
OH2LAH	VOIMASSA	
OH2LAK	VOIMASSA	
OH2LAW	VOIMASSA	
OH2LB	VOIMASSA	
OH2LBD	VOIMASSA	
OH2LBE	VOIMASSA	
OH2LBF	VOIMASSA	
OH2LBO	VOIMASSA	
OH2LBS	VOIMASSA	
OH2LBV	VOIMASSA	
OH2LCP	VOIMASSA	
OH2LCQ	VOIMASSA	
OH2LCV	VOIMASSA	
OH2LDS	VOIMASSA	
OH2LE	VOIMASSA	
OH2LFI	VOIMASSA	
OH2LFM	VOIMASSA	
OH2LGA	VOIMASSA	
OH2LGE	VOIMASSA	
OH2LGW	VOIMASSA	
OH2LH	VOIMASSA	
OH2LHD	VOIMASSA	
OH2LHE	VOIMASSA	
OH2LHH	VOIMASSA	
OH2LHT	VOIMASSA	
OH2LHW	VOIMASSA	
OH2LI	VOIMASSA	
OH2LIC	VOIMASSA	
OH2LIE	VOIMASSA	
OH2LIH	VOIMASSA	
OH2LIO	VOIMASSA	
OH2LIQ	VOIMASSA	
OH2LIR	VOIMASSA	
OH2LIY	VOIMASSA	
OH2LJD	VOIMASSA	
OH2LJE	VOIMASSA	
OH2LJH	VOIMASSA	
OH2LJS	VOIMASSA	
OH2LK	VOIMASSA	
OH2LKD	VOIMASSA	
OH2LKJ	VOIMASSA	
OH2LKO	VOIMASSA	
OH2LKV	VOIMASSA	
OH2LL	VOIMASSA	
OH2LLC	VOIMASSA	
OH2LM	VOIMASSA	
OH2LMK	VOIMASSA	
OH2LMY	VOIMASSA	
OH2LNA	VOIMASSA	
OH2LNF	VOIMASSA	
OH2LNH	VOIMASSA	
OH2LNJ	VOIMASSA	
OH2LNM	VOIMASSA	
OH2LNR	VOIMASSA	
OH2LNS	VOIMASSA	
OH2LNW	VOIMASSA	
OH2LOA	VOIMASSA	
OH2LOI	VOIMASSA	
OH2LOJ	VOIMASSA	
OH2LOS	VOIMASSA	
OH2LOU	VOIMASSA	
OH2LPW	VOIMASSA	
OH2LPY	VOIMASSA	
OH2LQ	VOIMASSA	
OH2LQF	VOIMASSA	
OH2LQJ	VOIMASSA	
OH2LQO	VOIMASSA	
OH2LQS	VOIMASSA	
OH2LR	VOIMASSA	
OH2LRD	VOIMASSA	
OH2LRE	VOIMASSA	
OH2LRG	VOIMASSA	
OH2LRH	VOIMASSA	
OH2LRI	VOIMASSA	
OH2LRO	VOIMASSA	
OH2LRQ	VOIMASSA	
OH2LRV	VOIMASSA	
OH2LS	VOIMASSA	
OH2LSE	VOIMASSA	
OH2LSF	VOIMASSA	
OH2LSJ	VOIMASSA	
OH2LSO	VOIMASSA	
OH2LTC	VOIMASSA	
OH2LTR	VOIMASSA	
OH2LTS	VOIMASSA	
OH2LU	VOIMASSA	
OH2LUR	VOIMASSA	
OH2LVD	VOIMASSA	
OH2LVE	VOIMASSA	
OH2LVI	VOIMASSA	
OH2LVM	VOIMASSA	
OH2LWN	VOIMASSA	
OH2LWO	VOIMASSA	
OH2LWT	VOIMASSA	
OH2LVZ	VOIMASSA	
OH2LX	VOIMASSA	
OH2LXB	VOIMASSA	
OH2LXC	VOIMASSA	
OH2LXO	VOIMASSA	
OH2LXY	VOIMASSA	
OH2LYH	VOIMASSA	
OH2LYK	VOIMASSA	
OH2LYS	VOIMASSA	
OH2LYW	VOIMASSA	
OH2LZC	VOIMASSA	
OH2LZI	VOIMASSA	
OH2LZK	VOIMASSA	
OH2LZL	VOIMASSA	
OH2LZN	VOIMASSA	
OH2LZP	VOIMASSA	
OH2M	VOIMASSA	
OH2MA	VOIMASSA	
OH2MAB	VOIMASSA	
OH2MAD	VOIMASSA	
OH2MAK	VOIMASSA	
OH2MAM	VOIMASSA	
OH2MAS	VOIMASSA	
OH2MAT	VOIMASSA	
OH2MBX	VOIMASSA	
OH2MCH	VOIMASSA	
OH2MCI	VOIMASSA	
OH2MCU	VOIMASSA	
OH2MD	VOIMASSA	
OH2MDJ	VOIMASSA	
OH2MDN	VOIMASSA	
OH2ME	VOIMASSA	
OH2MEE	VOIMASSA	
OH2MEG	VOIMASSA	
OH2MEL	VOIMASSA	
OH2MFE	VOIMASSA	
OH2MFS	VOIMASSA	
OH2MGA	VOIMASSA	
OH2MGE	VOIMASSA	
OH2MGJ	VOIMASSA	
OH2MGQ	VOIMASSA	
OH2MGS	VOIMASSA	
OH2MHI	VOIMASSA	
OH2MIN	VOIMASSA	
OH2MIS	VOIMASSA	
OH2MJG	VOIMASSA	
OH2MJI	VOIMASSA	
OH2MJX	VOIMASSA	
OH2MJY	VOIMASSA	
OH2MK	VOIMASSA	
OH2MKC	VOIMASSA	
OH2MKP	VOIMASSA	
OH2MKQ	VOIMASSA	
OH2MKW	VOIMASSA	
OH2MKX	VOIMASSA	
OH2ML	VOIMASSA	
OH2MLA	VOIMASSA	
OH2MLM	VOIMASSA	
OH2MLN	VOIMASSA	
OH2MLO	VOIMASSA	
OH2MLP	VOIMASSA	
OH2MLQ	VOIMASSA	
OH2MM	VOIMASSA	
OH2MME	VOIMASSA	
OH2MMY	VOIMASSA	
OH2MN	VOIMASSA	
OH2MNI	VOIMASSA	
OH2MO	VOIMASSA	
OH2MOC	VOIMASSA	
OH2MOH	VOIMASSA	
OH2MOK	VOIMASSA	
OH2MP	VOIMASSA	
OH2MPI	VOIMASSA	
OH2MPO	VOIMASSA	
OH2MPX	VOIMASSA	
OH2MPY	VOIMASSA	
OH2MQ	VOIMASSA	
OH2MQK	VOIMASSA	
OH2MRI	VOIMASSA	
OH2MRK	VOIMASSA	
OH2MRO	VOIMASSA	
OH2MRS	VOIMASSA	
OH2MRT	VOIMASSA	
OH2MRX	VOIMASSA	
OH2MS	VOIMASSA	
OH2MSN	VOIMASSA	
OH2MSP	VOIMASSA	
OH2MSU	VOIMASSA	
OH2MT	VOIMASSA	
OH2MTX	VOIMASSA	
OH2MU	VOIMASSA	
OH2MUI	VOIMASSA	
OH2MUX	VOIMASSA	
OH2MV	VOIMASSA	
OH2MW	KARENSSI	
OH2MWA	VOIMASSA	
OH2MWH	VOIMASSA	
OH2MVL	VOIMASSA	
OH2MXM	VOIMASSA	
OH2MXN	VOIMASSA	
OH2MXS	VOIMASSA	
OH2MXZ	VOIMASSA	
OH2MY	VOIMASSA	
OH2MYY	VOIMASSA	
OH2MZA	VOIMASSA	
OH2MZB	VOIMASSA	
OH2MZD	VOIMASSA	
OH2N	VOIMASSA	
OH2NAF	VOIMASSA	
OH2NAG	VOIMASSA	
OH2NAS	VOIMASSA	
OH2NB	VOIMASSA	
OH2NBC	VOIMASSA	
OH2NBK	VOIMASSA	
OH2NBS	VOIMASSA	
OH2NC	VOIMASSA	
OH2NCI	VOIMASSA	
OH2NCN	VOIMASSA	
OH2NCP	VOIMASSA	
OH2NCS	VOIMASSA	
OH2ND	VOIMASSA	
OH2NDB	VOIMASSA	
OH2NDP	VOIMASSA	
OH2NE	VOIMASSA	
OH2NED	VOIMASSA	
OH2NEE	VOIMASSA	
OH2NEM	VOIMASSA	
OH2NFI	VOIMASSA	
OH2NFN	VOIMASSA	
OH2NFT	VOIMASSA	
OH2NFZ	VOIMASSA	
OH2NGP	VOIMASSA	
OH2NGR	VOIMASSA	
OH2NGZ	VOIMASSA	
OH2NHH	VOIMASSA	
OH2NHJ	VOIMASSA	
OH2NHP	VOIMASSA	
OH2NII	VOIMASSA	
OH2NIM	VOIMASSA	
OH2NIN	VOIMASSA	
OH2NJK	VOIMASSA	
OH2NJN	VOIMASSA	
OH2NJR	VOIMASSA	
OH2NL	VOIMASSA	
OH2NLI	VOIMASSA	
OH2NLT	VOIMASSA	
OH2NM	VOIMASSA	
OH2NML	VOIMASSA	
OH2NMP	VOIMASSA	
OH2NMR	VOIMASSA	
OH2NMZ	VOIMASSA	
OH2NN	VOIMASSA	
OH2NNA	VOIMASSA	
OH2NNE	VOIMASSA	
OH2NO	VOIMASSA	
OH2NORA	KARENSSI	
OH2NOS	VOIMASSA	
OH2NP	VOIMASSA	
OH2NPE	VOIMASSA	
OH2NQD	VOIMASSA	
OH2NQH	VOIMASSA	
OH2NRA	VOIMASSA	
OH2NRG	VOIMASSA	
OH2NRI	VOIMASSA	
OH2NRV	VOIMASSA	
OH2NRZ	VOIMASSA	
OH2NS	KARENSSI	
OH2NSA	VOIMASSA	
OH2NSM	VOIMASSA	
OH2NSW	VOIMASSA	
OH2NT	VOIMASSA	
OH2NTA	VOIMASSA	
OH2NTD	VOIMASSA	
OH2NTW	VOIMASSA	
OH2NU	VOIMASSA	
OH2NUY	VOIMASSA	
OH2NW	VOIMASSA	
OH2NWB	VOIMASSA	
OH2NWF	VOIMASSA	
OH2NWG	VOIMASSA	
OH2NWM	VOIMASSA	
OH2NWR	VOIMASSA	
OH2NXC	VOIMASSA	
OH2NXH	VOIMASSA	
OH2NXQ	VOIMASSA	
OH2NXX	VOIMASSA	
OH2NYE	VOIMASSA	
OH2NZA	VOIMASSA	
OH2NZP	VOIMASSA	
OH2NZT	VOIMASSA	
OH2NZV	VOIMASSA	
OH2O	VOIMASSA	
OH2OA	KARENSSI	
OH2OC	VOIMASSA	
OH2OF	VOIMASSA	
OH2OH	VOIMASSA	
OH2OK	VOIMASSA	
OH2OKE	VOIMASSA	
OH2OLK	VOIMASSA	
OH2OLLI	VOIMASSA	
OH2ON	VOIMASSA	
OH2OO	VOIMASSA	
OH2OOO	VOIMASSA	
OH2OP	VOIMASSA	
OH2OPH	VOIMASSA	
OH2OSQ	VOIMASSA	
OH2OT	VOIMASSA	
OH2OV	VOIMASSA	
OH2OW	VOIMASSA	
OH2OX	VOIMASSA	
OH2P	VOIMASSA	
OH2PA	VOIMASSA	
OH2PASI	VOIMASSA	
OH2PAW	VOIMASSA	
OH2PB	VOIMASSA	
OH2PC	VOIMASSA	
OH2PH	VOIMASSA	
OH2PILI	VOIMASSA	
OH2PJ	KARENSSI	
OH2PK	VOIMASSA	
OH2PL	VOIMASSA	
OH2PLA	VOIMASSA	
OH2PM	VOIMASSA	
OH2PN	KARENSSI	
OH2PO	VOIMASSA	
OH2PP	VOIMASSA	
OH2PQ	VOIMASSA	
OH2PR	VOIMASSA	
OH2PS	VOIMASSA	
OH2PT	VOIMASSA	
OH2PU	VOIMASSA	
OH2PV	VOIMASSA	
OH2PW	VOIMASSA	
OH2Q	VOIMASSA	
OH2QC	VOIMASSA	
OH2QJ	VOIMASSA	
OH2QM	VOIMASSA	
OH2QO	VOIMASSA	
OH2QS	VOIMASSA	
OH2QT	VOIMASSA	
OH2QV	VOIMASSA	
OH2QX	KARENSSI	
OH2R	VOIMASSA	
OH2RA	VOIMASSA	
OH2RAA	VOIMASSA	
OH2RAFU	VOIMASSA	
OH2RAY	VOIMASSA	
OH2RB	KARENSSI	
OH2RBA	VOIMASSA	
OH2RBB	VOIMASSA	
OH2RBV	VOIMASSA	
OH2RC	VOIMASSA	
OH2RCH	VOIMASSA	
OH2RDG	VOIMASSA	
OH2RDH	VOIMASSA	
OH2RDK	VOIMASSA	
OH2RDP	VOIMASSA	
OH2RDS	VOIMASSA	
OH2RDU	VOIMASSA	
OH2RDY	VOIMASSA	
OH2RE	VOIMASSA	
OH2REA	VOIMASSA	
OH2RF	VOIMASSA	
OH2RG	VOIMASSA	
OH2RH	VOIMASSA	
OH2RHW	VOIMASSA	
OH2RHWS	VOIMASSA	
OH2RJ	VOIMASSA	
OH2RK	VOIMASSA	
OH2RL	VOIMASSA	
OH2RM	VOIMASSA	
OH2RO	VOIMASSA	
OH2ROCK	VOIMASSA	
OH2RR	VOIMASSA	
OH2RS	VOIMASSA	
OH2RT	VOIMASSA	
OH2RU	VOIMASSA	
OH2RUA	VOIMASSA	
OH2RUB	VOIMASSA	
OH2RUC	VOIMASSA	
OH2RUF	VOIMASSA	
OH2RUL	VOIMASSA	
OH2RUP	VOIMASSA	
OH2RX	VOIMASSA	
OH2RZ	KARENSSI	
OH2S	VOIMASSA	
OH2S100F	VOIMASSA	
OH2SA	VOIMASSA	
OH2SAAB	VOIMASSA	
OH2SAR	VOIMASSA	
OH2SATU	VOIMASSA	
OH2SB	VOIMASSA	
OH2SC	VOIMASSA	
OH2SE	VOIMASSA	
OH2SEC	VOIMASSA	
OH2SF	VOIMASSA	
OH2SG	VOIMASSA	
OH2SGF	VOIMASSA	
OH2SH	VOIMASSA	
OH2SHF	VOIMASSA	
OH2SHP	VOIMASSA	
OH2SIX	VOIMASSA	
OH2SJ	VOIMASSA	
OH2SK	VOIMASSA	
OH2SM	VOIMASSA	
OH2SN	VOIMASSA	
OH2SO	VOIMASSA	
OH2SP	VOIMASSA	
OH2SRAL	VOIMASSA	
OH2SS	KARENSSI	
OH2SSA	VOIMASSA	
OH2SSTV	VOIMASSA	
OH2SUF	VOIMASSA	
OH2SV	VOIMASSA	
OH2SW	VOIMASSA	
OH2T	VOIMASSA	
OH2TA	VOIMASSA	
OH2TAS	VOIMASSA	
OH2TB	VOIMASSA	
OH2TBG	VOIMASSA	
OH2TC	VOIMASSA	
OH2TE	VOIMASSA	
OH2TH	VOIMASSA	
OH2TI	VOIMASSA	
OH2TIMO	VOIMASSA	
OH2TJ	VOIMASSA	
OH2TJK	VOIMASSA	
OH2TK	VOIMASSA	
OH2TL	VOIMASSA	
OH2TM	VOIMASSA	
OH2TO	VOIMASSA	
OH2TP	VOIMASSA	
OH2TQ	VOIMASSA	
OH2TS	VOIMASSA	
OH2TT	VOIMASSA	
OH2TW	VOIMASSA	
OH2TWI	VOIMASSA	
OH2TX	VOIMASSA	
OH2U	VOIMASSA	
OH2UA	VOIMASSA	
OH2UAM	VOIMASSA	
OH2UAP	VOIMASSA	
OH2UAT	VOIMASSA	
OH2UB	VOIMASSA	
OH2UBA	VOIMASSA	
OH2UBF	VOIMASSA	
OH2UBG	VOIMASSA	
OH2UBM	VOIMASSA	
OH2UBN	VOIMASSA	
OH2UBP	VOIMASSA	
OH2UBR	VOIMASSA	
OH2UBV	VOIMASSA	
OH2UBW	VOIMASSA	
OH2UBY	VOIMASSA	
OH2UCH	VOIMASSA	
OH2UCI	VOIMASSA	
OH2UCR	VOIMASSA	
OH2UCY	VOIMASSA	
OH2UCZ	VOIMASSA	
OH2UD	VOIMASSA	
OH2UDD	VOIMASSA	
OH2UDI	VOIMASSA	
OH2UDM	VOIMASSA	
OH2UDN	VOIMASSA	
OH2UDQ	VOIMASSA	
OH2UDS	VOIMASSA	
OH2UF	VOIMASSA	
OH2UG	VOIMASSA	
OH2UH	VOIMASSA	
OH2UHF	VOIMASSA	
OH2UM	VOIMASSA	
OH2UN	VOIMASSA	
OH2US	VOIMASSA	
OH2UU	VOIMASSA	
OH2V	KARENSSI	
OH2W	VOIMASSA	
OH2VA	VOIMASSA	
OH2WA	VOIMASSA	
OH2WC	VOIMASSA	
OH2VE	VOIMASSA	
OH2VG	VOIMASSA	
OH2VH	VOIMASSA	
OH2VHF	VOIMASSA	
OH2VHH	VOIMASSA	
OH2WI	VOIMASSA	
OH2VJ	VOIMASSA	
OH2WJ	VOIMASSA	
OH2VK	VOIMASSA	
OH2WK	VOIMASSA	
OH2VL	VOIMASSA	
OH2WM	VOIMASSA	
OH2VMP	VOIMASSA	
OH2VN	VOIMASSA	
OH2VP	VOIMASSA	
OH2VR	VOIMASSA	
OH2WR	VOIMASSA	
OH2VSY	VOIMASSA	
OH2VT	VOIMASSA	
OH2WT	VOIMASSA	
OH2VTT	VOIMASSA	
OH2VU	VOIMASSA	
OH2WU	VOIMASSA	
OH2VW	VOIMASSA	
OH2WX	VOIMASSA	
OH2VZ	VOIMASSA	
OH2X	VOIMASSA	
OH2XAB	VOIMASSA	
OH2XB	VOIMASSA	
OH2XD	VOIMASSA	
OH2XF	VOIMASSA	
OH2XK	VOIMASSA	
OH2XN	VOIMASSA	
OH2XO	VOIMASSA	
OH2XW	VOIMASSA	
OH2XX	VOIMASSA	
OH2Y	VOIMASSA	
OH2YA	VOIMASSA	
OH2YE	KARENSSI	
OH2YF	VOIMASSA	
OH2YG	VOIMASSA	
OH2YL	VOIMASSA	
OH2YLE	VOIMASSA	
OH2YLS	VOIMASSA	
OH2YN	VOIMASSA	
OH2YOTA	VOIMASSA	
OH2YQ	VOIMASSA	
OH2YT	KARENSSI	
OH2YV	VOIMASSA	
OH2YX	VOIMASSA	
OH2YY	VOIMASSA	
OH2Z	VOIMASSA	
OH2ZA	VOIMASSA	
OH2ZAB	VOIMASSA	
OH2ZAR	VOIMASSA	
OH2ZAX	VOIMASSA	
OH2ZAZ	VOIMASSA	
OH2ZE	VOIMASSA	
OH2ZH	VOIMASSA	
OH2ZL	VOIMASSA	
OH2ZP	VOIMASSA	
OH2ZQ	VOIMASSA	
OH2ZT	VOIMASSA	
OH2ZY	VOIMASSA	
OH2ZZ	VOIMASSA	
OH3077F	VOIMASSA	
OH3A	VOIMASSA	
OH3AA	VOIMASSA	
OH3AB	VOIMASSA	
OH3ABN	VOIMASSA	
OH3ABU	VOIMASSA	
OH3AC	VOIMASSA	
OH3ACA	VOIMASSA	
OH3ACE	VOIMASSA	
OH3AD	VOIMASSA	
OH3AF	VOIMASSA	
OH3AG	VOIMASSA	
OH3AN	VOIMASSA	
OH3AP	VOIMASSA	
OH3AR	VOIMASSA	
OH3AV	VOIMASSA	
OH3AVA	VOIMASSA	
OH3AVG	VOIMASSA	
OH3AVQ	VOIMASSA	
OH3AWW	VOIMASSA	
OH3AXA	VOIMASSA	
OH3AYP	VOIMASSA	
OH3AYT	VOIMASSA	
OH3AZB	VOIMASSA	
OH3AZI	VOIMASSA	
OH3AZL	VOIMASSA	
OH3AZN	VOIMASSA	
OH3AZR	VOIMASSA	
OH3BA	VOIMASSA	
OH3BAE	VOIMASSA	
OH3BAL	VOIMASSA	
OH3BB	KARENSSI	
OH3BBK	VOIMASSA	
OH3BBQ	VOIMASSA	
OH3BBX	VOIMASSA	
OH3BC	VOIMASSA	
OH3BCL	VOIMASSA	
OH3BCT	VOIMASSA	
OH3BCX	VOIMASSA	
OH3BCZ	VOIMASSA	
OH3BDS	VOIMASSA	
OH3BDX	VOIMASSA	
OH3BEL	VOIMASSA	
OH3BET	VOIMASSA	
OH3BEY	VOIMASSA	
OH3BFD	VOIMASSA	
OH3BFI	VOIMASSA	
OH3BFQ	VOIMASSA	
OH3BFV	VOIMASSA	
OH3BFX	VOIMASSA	
OH3BGM	VOIMASSA	
OH3BGS	VOIMASSA	
OH3BHL	VOIMASSA	
OH3BHX	VOIMASSA	
OH3BI	VOIMASSA	
OH3BIK	VOIMASSA	
OH3BIU	VOIMASSA	
OH3BJL	VOIMASSA	
OH3BJQ	VOIMASSA	
OH3BJR	VOIMASSA	
OH3BJX	VOIMASSA	
OH3BK	VOIMASSA	
OH3BKI	VOIMASSA	
OH3BKL	VOIMASSA	
OH3BKN	VOIMASSA	
OH3BKR	VOIMASSA	
OH3BKV	VOIMASSA	
OH3BLB	VOIMASSA	
OH3BLT	VOIMASSA	
OH3BMA	VOIMASSA	
OH3BMT	VOIMASSA	
OH3BN	VOIMASSA	
OH3BNC	VOIMASSA	
OH3BNT	VOIMASSA	
OH3BOG	VOIMASSA	
OH3BOL	VOIMASSA	
OH3BOU	VOIMASSA	
OH3BP	VOIMASSA	
OH3BPA	VOIMASSA	
OH3BPH	VOIMASSA	
OH3BPR	VOIMASSA	
OH3BPV	VOIMASSA	
OH3BPY	VOIMASSA	
OH3BQA	VOIMASSA	
OH3BQD	VOIMASSA	
OH3BQK	VOIMASSA	
OH3BQX	VOIMASSA	
OH3BRI	VOIMASSA	
OH3BRJ	VOIMASSA	
OH3BRK	VOIMASSA	
OH3BRU	VOIMASSA	
OH3BSG	VOIMASSA	
OH3BTN	VOIMASSA	
OH3BTP	VOIMASSA	
OH3BU	VOIMASSA	
OH3BUK	VOIMASSA	
OH3BUR	VOIMASSA	
OH3BV	VOIMASSA	
OH3BVN	VOIMASSA	
OH3BVQ	VOIMASSA	
OH3BVS	VOIMASSA	
OH3BVV	VOIMASSA	
OH3BWV	VOIMASSA	
OH3BXF	VOIMASSA	
OH3BY	VOIMASSA	
OH3BYZ	VOIMASSA	
OH3BZK	VOIMASSA	
OH3BZS	VOIMASSA	
OH3CA	VOIMASSA	
OH3CAB	VOIMASSA	
OH3CAJ	VOIMASSA	
OH3CAP	VOIMASSA	
OH3CBA	VOIMASSA	
OH3CBN	VOIMASSA	
OH3CBT	VOIMASSA	
OH3CC	VOIMASSA	
OH3CCP	VOIMASSA	
OH3CCT	VOIMASSA	
OH3CCX	VOIMASSA	
OH3CD	VOIMASSA	
OH3CDR	VOIMASSA	
OH3CDS	VOIMASSA	
OH3CDV	VOIMASSA	
OH3CDY	VOIMASSA	
OH3CE	VOIMASSA	
OH3CEK	VOIMASSA	
OH3CEO	VOIMASSA	
OH3CEU	VOIMASSA	
OH3CFL	VOIMASSA	
OH3CFR	VOIMASSA	
OH3CFT	VOIMASSA	
OH3CG	VOIMASSA	
OH3CGB	VOIMASSA	
OH3CGE	VOIMASSA	
OH3CGJ	VOIMASSA	
OH3CGK	VOIMASSA	
OH3CGV	VOIMASSA	
OH3CH	VOIMASSA	
OH3CHA	VOIMASSA	
OH3CHG	VOIMASSA	
OH3CJ	VOIMASSA	
OH3CK	VOIMASSA	
OH3CRAC	KARENSSI	
OH3CT	VOIMASSA	
OH3CU	VOIMASSA	
OH3CV	VOIMASSA	
OH3CW	VOIMASSA	
OH3D	VOIMASSA	
OH3DB	VOIMASSA	
OH3DC	VOIMASSA	
OH3DD	VOIMASSA	
OH3DF	VOIMASSA	
OH3DMRA	VOIMASSA	
OH3DMRB	VOIMASSA	
OH3DO	KARENSSI	
OH3DP	VOIMASSA	
OH3DX	VOIMASSA	
OH3DY	VOIMASSA	
OH3DZ	VOIMASSA	
OH3E	VOIMASSA	
OH3EAD	VOIMASSA	
OH3EAJ	VOIMASSA	
OH3EAK	VOIMASSA	
OH3EAU	VOIMASSA	
OH3EAW	VOIMASSA	
OH3EAX	VOIMASSA	
OH3EB	VOIMASSA	
OH3EBF	VOIMASSA	
OH3EBN	VOIMASSA	
OH3EBX	VOIMASSA	
OH3EBY	VOIMASSA	
OH3EBZ	VOIMASSA	
OH3ECB	VOIMASSA	
OH3ECR	VOIMASSA	
OH3ECS	VOIMASSA	
OH3ECT	VOIMASSA	
OH3ECU	VOIMASSA	
OH3EDL	VOIMASSA	
OH3EDM	VOIMASSA	
OH3EDT	VOIMASSA	
OH3EEL	VOIMASSA	
OH3EES	VOIMASSA	
OH3EEU	VOIMASSA	
OH3EFE	VOIMASSA	
OH3EFG	VOIMASSA	
OH3EFZ	VOIMASSA	
OH3EGF	VOIMASSA	
OH3EGJ	VOIMASSA	
OH3EGL	VOIMASSA	
OH3EGM	VOIMASSA	
OH3EGS	VOIMASSA	
OH3EGX	VOIMASSA	
OH3EGY	VOIMASSA	
OH3EH	VOIMASSA	
OH3EHO	VOIMASSA	
OH3EHR	VOIMASSA	
OH3EI	VOIMASSA	
OH3EID	VOIMASSA	
OH3EIF	VOIMASSA	
OH3EIG	VOIMASSA	
OH3EIK	VOIMASSA	
OH3EIO	VOIMASSA	
OH3EIT	VOIMASSA	
OH3EIZ	VOIMASSA	
OH3EJA	VOIMASSA	
OH3EK	VOIMASSA	
OH3EKM	VOIMASSA	
OH3EKN	VOIMASSA	
OH3EKP	VOIMASSA	
OH3EKQ	VOIMASSA	
OH3EL	VOIMASSA	
OH3ELB	VOIMASSA	
OH3ELC	VOIMASSA	
OH3ELJ	VOIMASSA	
OH3ELK	VOIMASSA	
OH3ELQ	VOIMASSA	
OH3ELU	VOIMASSA	
OH3EM	VOIMASSA	
OH3EMC	VOIMASSA	
OH3EMR	VOIMASSA	
OH3EMS	VOIMASSA	
OH3ENB	VOIMASSA	
OH3ENH	VOIMASSA	
OH3ENI	VOIMASSA	
OH3ENK	VOIMASSA	
OH3ENL	VOIMASSA	
OH3ENM	VOIMASSA	
OH3ENU	VOIMASSA	
OH3EOA	VOIMASSA	
OH3EON	VOIMASSA	
OH3EPC	VOIMASSA	
OH3EPE	VOIMASSA	
OH3EPV	VOIMASSA	
OH3EPX	VOIMASSA	
OH3EPZ	VOIMASSA	
OH3EQA	VOIMASSA	
OH3EQN	VOIMASSA	
OH3EQO	VOIMASSA	
OH3EQQ	VOIMASSA	
OH3EQS	VOIMASSA	
OH3EQX	VOIMASSA	
OH3EQY	VOIMASSA	
OH3ERC	VOIMASSA	
OH3ERF	VOIMASSA	
OH3ERI	VOIMASSA	
OH3ERV	VOIMASSA	
OH3ES	VOIMASSA	
OH3ESJ	VOIMASSA	
OH3ESN	VOIMASSA	
OH3ESX	VOIMASSA	
OH3ET	VOIMASSA	
OH3ETJ	VOIMASSA	
OH3ETL	VOIMASSA	
OH3ETZ	VOIMASSA	
OH3EUA	VOIMASSA	
OH3EUB	VOIMASSA	
OH3EUC	VOIMASSA	
OH3EUE	VOIMASSA	
OH3EUF	VOIMASSA	
OH3EUJ	VOIMASSA	
OH3EV	VOIMASSA	
OH3EVA	VOIMASSA	
OH3EWB	VOIMASSA	
OH3EWC	VOIMASSA	
OH3EVH	VOIMASSA	
OH3EVJ	VOIMASSA	
OH3EVK	VOIMASSA	
OH3EVM	VOIMASSA	
OH3EVO	VOIMASSA	
OH3EWP	VOIMASSA	
OH3EVQ	VOIMASSA	
OH3EVR	VOIMASSA	
OH3EVS	VOIMASSA	
OH3EVT	VOIMASSA	
OH3EX	VOIMASSA	
OH3EXG	VOIMASSA	
OH3EXH	VOIMASSA	
OH3EXI	VOIMASSA	
OH3EXM	VOIMASSA	
OH3EXN	VOIMASSA	
OH3EXQ	VOIMASSA	
OH3EXR	VOIMASSA	
OH3EXS	VOIMASSA	
OH3EXY	VOIMASSA	
OH3EXZ	VOIMASSA	
OH3EY	VOIMASSA	
OH3EYB	VOIMASSA	
OH3EYE	VOIMASSA	
OH3EYF	VOIMASSA	
OH3EYH	VOIMASSA	
OH3EYR	VOIMASSA	
OH3EYU	VOIMASSA	
OH3EYZ	VOIMASSA	
OH3EZ	VOIMASSA	
OH3EZH	VOIMASSA	
OH3EZI	VOIMASSA	
OH3EZO	VOIMASSA	
OH3EZQ	VOIMASSA	
OH3FAM	VOIMASSA	
OH3FBM	VOIMASSA	
OH3FBS	VOIMASSA	
OH3FC	VOIMASSA	
OH3FCA	VOIMASSA	
OH3FCB	VOIMASSA	
OH3FCD	VOIMASSA	
OH3FCG	VOIMASSA	
OH3FCT	VOIMASSA	
OH3FEI	VOIMASSA	
OH3FER	VOIMASSA	
OH3FEZ	VOIMASSA	
OH3FF	VOIMASSA	
OH3FFB	VOIMASSA	
OH3FFQ	VOIMASSA	
OH3FFS	VOIMASSA	
OH3FFV	VOIMASSA	
OH3FG	KARENSSI	
OH3FGB	VOIMASSA	
OH3FGC	VOIMASSA	
OH3FGD	VOIMASSA	
OH3FGN	VOIMASSA	
OH3FGV	VOIMASSA	
OH3FGX	VOIMASSA	
OH3FHY	VOIMASSA	
OH3FHZ	VOIMASSA	
OH3FI	VOIMASSA	
OH3FIE	VOIMASSA	
OH3FIO	VOIMASSA	
OH3FIP	VOIMASSA	
OH3FJL	VOIMASSA	
OH3FJM	VOIMASSA	
OH3FJQ	VOIMASSA	
OH3FJW	VOIMASSA	
OH3FK	VOIMASSA	
OH3FKY	VOIMASSA	
OH3FL	VOIMASSA	
OH3FLF	VOIMASSA	
OH3FLZ	VOIMASSA	
OH3FM	VOIMASSA	
OH3FMF	VOIMASSA	
OH3FMH	VOIMASSA	
OH3FMI	VOIMASSA	
OH3FMJ	VOIMASSA	
OH3FMK	VOIMASSA	
OH3FML	VOIMASSA	
OH3FMO	VOIMASSA	
OH3FMP	VOIMASSA	
OH3FMU	VOIMASSA	
OH3FN	VOIMASSA	
OH3FNM	VOIMASSA	
OH3FNN	VOIMASSA	
OH3FNO	VOIMASSA	
OH3FNS	VOIMASSA	
OH3FNT	VOIMASSA	
OH3FNU	VOIMASSA	
OH3FNV	VOIMASSA	
OH3FOB	VOIMASSA	
OH3FOG	VOIMASSA	
OH3FON	VOIMASSA	
OH3FOQ	VOIMASSA	
OH3FOX	VOIMASSA	
OH3FP	VOIMASSA	
OH3FPM	VOIMASSA	
OH3FQB	VOIMASSA	
OH3FQC	VOIMASSA	
OH3FQR	VOIMASSA	
OH3FQW	VOIMASSA	
OH3FQX	VOIMASSA	
OH3FR	VOIMASSA	
OH3FRL	VOIMASSA	
OH3FRN	VOIMASSA	
OH3FRX	VOIMASSA	
OH3FSR	VOIMASSA	
OH3FSW	VOIMASSA	
OH3FT	VOIMASSA	
OH3FTC	VOIMASSA	
OH3FTH	VOIMASSA	
OH3FTI	VOIMASSA	
OH3FTQ	VOIMASSA	
OH3FU	VOIMASSA	
OH3FWD	VOIMASSA	
OH3FWE	VOIMASSA	
OH3FWF	VOIMASSA	
OH3FWG	VOIMASSA	
OH3FWH	VOIMASSA	
OH3FWI	VOIMASSA	
OH3FWJ	VOIMASSA	
OH3FVK	VOIMASSA	
OH3FVP	VOIMASSA	
OH3FVQ	VOIMASSA	
OH3FVR	VOIMASSA	
OH3FVS	VOIMASSA	
OH3FVU	VOIMASSA	
OH3FVV	VOIMASSA	
OH3FVW	VOIMASSA	
OH3FVX	VOIMASSA	
OH3FX	VOIMASSA	
OH3FXF	VOIMASSA	
OH3FXG	VOIMASSA	
OH3FYD	VOIMASSA	
OH3FYE	VOIMASSA	
OH3FYF	VOIMASSA	
OH3FYN	VOIMASSA	
OH3FYO	VOIMASSA	
OH3FZA	VOIMASSA	
OH3FZQ	VOIMASSA	
OH3FZR	VOIMASSA	
OH3FZY	VOIMASSA	
OH3GAE	VOIMASSA	
OH3GAI	VOIMASSA	
OH3GAK	VOIMASSA	
OH3GB	VOIMASSA	
OH3GBQ	VOIMASSA	
OH3GBR	VOIMASSA	
OH3GBS	VOIMASSA	
OH3GBV	VOIMASSA	
OH3GBW	VOIMASSA	
OH3GCI	VOIMASSA	
OH3GCL	VOIMASSA	
OH3GD	VOIMASSA	
OH3GDD	VOIMASSA	
OH3GDO	VOIMASSA	
OH3GE	KARENSSI	
OH3GED	VOIMASSA	
OH3GEF	VOIMASSA	
OH3GFX	VOIMASSA	
OH3GG	VOIMASSA	
OH3GGD	VOIMASSA	
OH3GGM	VOIMASSA	
OH3GGQ	VOIMASSA	
OH3GHW	VOIMASSA	
OH3GI	VOIMASSA	
OH3GIJ	VOIMASSA	
OH3GJ	VOIMASSA	
OH3GKA	VOIMASSA	
OH3GKB	VOIMASSA	
OH3GKE	VOIMASSA	
OH3GKG	VOIMASSA	
OH3GLY	VOIMASSA	
OH3GM	VOIMASSA	
OH3GMG	VOIMASSA	
OH3GMM	VOIMASSA	
OH3GMV	VOIMASSA	
OH3GMZ	VOIMASSA	
OH3GNI	VOIMASSA	
OH3GNK	VOIMASSA	
OH3GNU	VOIMASSA	
OH3GNY	VOIMASSA	
OH3GO	VOIMASSA	
OH3GOH	VOIMASSA	
OH3GOI	VOIMASSA	
OH3GOJ	VOIMASSA	
OH3GOQ	VOIMASSA	
OH3GOX	VOIMASSA	
OH3GPD	VOIMASSA	
OH3GPF	VOIMASSA	
OH3GPG	VOIMASSA	
OH3GPH	VOIMASSA	
OH3GPJ	VOIMASSA	
OH3GQE	VOIMASSA	
OH3GQL	VOIMASSA	
OH3GR	VOIMASSA	
OH3GRB	VOIMASSA	
OH3GRH	VOIMASSA	
OH3GSH	VOIMASSA	
OH3GSU	VOIMASSA	
OH3GTA	VOIMASSA	
OH3GTV	VOIMASSA	
OH3GUH	VOIMASSA	
OH3GUT	VOIMASSA	
OH3GUX	VOIMASSA	
OH3GUZ	VOIMASSA	
OH3GWB	VOIMASSA	
OH3GVC	VOIMASSA	
OH3GWO	VOIMASSA	
OH3GWQ	VOIMASSA	
OH3GWU	VOIMASSA	
OH3GWV	VOIMASSA	
OH3GX	VOIMASSA	
OH3GXQ	VOIMASSA	
OH3GXU	VOIMASSA	
OH3GYP	VOIMASSA	
OH3GZ	VOIMASSA	
OH3HA	VOIMASSA	
OH3HAH	VOIMASSA	
OH3HAMI	VOIMASSA	
OH3HAU	VOIMASSA	
OH3HAW	VOIMASSA	
OH3HB	VOIMASSA	
OH3HBH	VOIMASSA	
OH3HBQ	VOIMASSA	
OH3HBY	VOIMASSA	
OH3HCH	VOIMASSA	
OH3HCI	VOIMASSA	
OH3HCN	VOIMASSA	
OH3HD	VOIMASSA	
OH3HDE	VOIMASSA	
OH3HE	VOIMASSA	
OH3HEI	VOIMASSA	
OH3HEL	VOIMASSA	
OH3HES	VOIMASSA	
OH3HF	VOIMASSA	
OH3HFK	VOIMASSA	
OH3HGB	VOIMASSA	
OH3HGE	VOIMASSA	
OH3HH	VOIMASSA	
OH3HHO	VOIMASSA	
OH3HI	VOIMASSA	
OH3HID	VOIMASSA	
OH3HJF	VOIMASSA	
OH3HKC	VOIMASSA	
OH3HKH	VOIMASSA	
OH3HL	VOIMASSA	
OH3HLI	VOIMASSA	
OH3HLY	VOIMASSA	
OH3HM	VOIMASSA	
OH3HMI	VOIMASSA	
OH3HMM	VOIMASSA	
OH3HMU	VOIMASSA	
OH3HN	VOIMASSA	
OH3HNI	VOIMASSA	
OH3HNU	VOIMASSA	
OH3HNY	VOIMASSA	
OH3HNZ	VOIMASSA	
OH3HO	VOIMASSA	
OH3HOA	VOIMASSA	
OH3HOB	VOIMASSA	
OH3HOC	VOIMASSA	
OH3HOO	VOIMASSA	
OH3HOS	VOIMASSA	
OH3HOV	VOIMASSA	
OH3HP	VOIMASSA	
OH3HPQ	VOIMASSA	
OH3HPU	VOIMASSA	
OH3HPV	VOIMASSA	
OH3HQX	VOIMASSA	
OH3HQY	VOIMASSA	
OH3HRK	VOIMASSA	
OH3HS	VOIMASSA	
OH3HSU	VOIMASSA	
OH3HT	VOIMASSA	
OH3HTI	VOIMASSA	
OH3HTR	VOIMASSA	
OH3HTU	VOIMASSA	
OH3HUK	VOIMASSA	
OH3HUV	VOIMASSA	
OH3HW	VOIMASSA	
OH3HWF	VOIMASSA	
OH3HVP	VOIMASSA	
OH3HVR	VOIMASSA	
OH3HVS	VOIMASSA	
OH3HWU	VOIMASSA	
OH3HWX	VOIMASSA	
OH3HWY	VOIMASSA	
OH3HWZ	VOIMASSA	
OH3HX	VOIMASSA	
OH3HY	VOIMASSA	
OH3HYO	VOIMASSA	
OH3HYP	VOIMASSA	
OH3HZ	VOIMASSA	
OH3HZB	VOIMASSA	
OH3HZO	VOIMASSA	
OH3HZQ	VOIMASSA	
OH3ID	VOIMASSA	
OH3IE	VOIMASSA	
OH3IH	VOIMASSA	
OH3II	VOIMASSA	
OH3IJ	VOIMASSA	
OH3IKH	VOIMASSA	
OH3IM	VOIMASSA	
OH3INF	VOIMASSA	
OH3IO	VOIMASSA	
OH3IQ	VOIMASSA	
OH3IR	VOIMASSA	
OH3IS	VOIMASSA	
OH3IX	VOIMASSA	
OH3IZ	VOIMASSA	
OH3J	VOIMASSA	
OH3JA	VOIMASSA	
OH3JAA	VOIMASSA	
OH3JAJ	VOIMASSA	
OH3JBM	VOIMASSA	
OH3JBT	VOIMASSA	
OH3JBY	VOIMASSA	
OH3JCB	VOIMASSA	
OH3JCE	VOIMASSA	
OH3JCM	VOIMASSA	
OH3JDT	VOIMASSA	
OH3JDZ	VOIMASSA	
OH3JE	VOIMASSA	
OH3JF	VOIMASSA	
OH3JFF	VOIMASSA	
OH3JG	VOIMASSA	
OH3JGV	VOIMASSA	
OH3JHQ	VOIMASSA	
OH3JJ	VOIMASSA	
OH3JK	VOIMASSA	
OH3JKF	VOIMASSA	
OH3JKO	VOIMASSA	
OH3JKV	VOIMASSA	
OH3JL	VOIMASSA	
OH3JLF	VOIMASSA	
OH3JM	VOIMASSA	
OH3JMD	VOIMASSA	
OH3JMJ	VOIMASSA	
OH3JMV	VOIMASSA	
OH3JMW	VOIMASSA	
OH3JMX	VOIMASSA	
OH3JO	VOIMASSA	
OH3JOP	VOIMASSA	
OH3JOSE	VOIMASSA	
OH3JP	VOIMASSA	
OH3JQ	VOIMASSA	
OH3JR	VOIMASSA	
OH3JRN	VOIMASSA	
OH3JRX	VOIMASSA	
OH3JSX	VOIMASSA	
OH3JT	VOIMASSA	
OH3JU	VOIMASSA	
OH3JUE	VOIMASSA	
OH3JV	VOIMASSA	
OH3JW	VOIMASSA	
OH3JVG	VOIMASSA	
OH3JZ	VOIMASSA	
OH3JZA	VOIMASSA	
OH3K	VOIMASSA	
OH3KA	VOIMASSA	
OH3KAQ	VOIMASSA	
OH3KARI	VOIMASSA	
OH3KAV	VOIMASSA	
OH3KBL	VOIMASSA	
OH3KBO	VOIMASSA	
OH3KC	VOIMASSA	
OH3KCC	VOIMASSA	
OH3KCM	VOIMASSA	
OH3KCO	VOIMASSA	
OH3KCT	VOIMASSA	
OH3KD	VOIMASSA	
OH3KDO	VOIMASSA	
OH3KES	VOIMASSA	
OH3KEV	VOIMASSA	
OH3KF	VOIMASSA	
OH3KFZ	VOIMASSA	
OH3KGB	VOIMASSA	
OH3KGR	VOIMASSA	
OH3KH	VOIMASSA	
OH3KHG	VOIMASSA	
OH3KHL	VOIMASSA	
OH3KHP	VOIMASSA	
OH3KJ	VOIMASSA	
OH3KJM	VOIMASSA	
OH3KJX	VOIMASSA	
OH3KK	VOIMASSA	
OH3KKK	VOIMASSA	
OH3KKW	VOIMASSA	
OH3KL	VOIMASSA	
OH3KLA	VOIMASSA	
OH3KLG	VOIMASSA	
OH3KLJ	VOIMASSA	
OH3KLT	VOIMASSA	
OH3KM	VOIMASSA	
OH3KMH	VOIMASSA	
OH3KN	VOIMASSA	
OH3KO	VOIMASSA	
OH3KOH	VOIMASSA	
OH3KOMA	VOIMASSA	
OH3KON	VOIMASSA	
OH3KOY	VOIMASSA	
OH3KP	VOIMASSA	
OH3KPL	VOIMASSA	
OH3KPY	VOIMASSA	
OH3KQ	VOIMASSA	
OH3KQD	VOIMASSA	
OH3KR	VOIMASSA	
OH3KRB	VOIMASSA	
OH3KRG	VOIMASSA	
OH3KRH	VOIMASSA	
OH3KS	VOIMASSA	
OH3KSS	VOIMASSA	
OH3KT	VOIMASSA	
OH3KU	VOIMASSA	
OH3KUN	VOIMASSA	
OH3KV	VOIMASSA	
OH3KWQ	VOIMASSA	
OH3KVR	VOIMASSA	
OH3KVS	VOIMASSA	
OH3KWW	VOIMASSA	
OH3KVZ	VOIMASSA	
OH3KX	VOIMASSA	
OH3KY	VOIMASSA	
OH3KYJ	VOIMASSA	
OH3KYO	VOIMASSA	
OH3KYZ	VOIMASSA	
OH3KZ	VOIMASSA	
OH3KZB	VOIMASSA	
OH3KZR	VOIMASSA	
OH3LAL	VOIMASSA	
OH3LB	VOIMASSA	
OH3LBC	VOIMASSA	
OH3LCB	VOIMASSA	
OH3LCG	VOIMASSA	
OH3LCH	VOIMASSA	
OH3LCR	VOIMASSA	
OH3LCS	VOIMASSA	
OH3LCZ	VOIMASSA	
OH3LD	VOIMASSA	
OH3LDL	VOIMASSA	
OH3LEA	VOIMASSA	
OH3LFQ	VOIMASSA	
OH3LG	VOIMASSA	
OH3LGG	VOIMASSA	
OH3LGO	VOIMASSA	
OH3LH	VOIMASSA	
OH3LIP	VOIMASSA	
OH3LIS	VOIMASSA	
OH3LIU	VOIMASSA	
OH3LJ	VOIMASSA	
OH3LJB	VOIMASSA	
OH3LJC	VOIMASSA	
OH3LJU	VOIMASSA	
OH3LK	VOIMASSA	
OH3LKU	VOIMASSA	
OH3LL	VOIMASSA	
OH3LLF	VOIMASSA	
OH3LLQ	VOIMASSA	
OH3LMB	VOIMASSA	
OH3LMC	VOIMASSA	
OH3LMG	VOIMASSA	
OH3LMM	VOIMASSA	
OH3LMN	VOIMASSA	
OH3LN	VOIMASSA	
OH3LO	VOIMASSA	
OH3LOD	VOIMASSA	
OH3LOM	VOIMASSA	
OH3LOR	VOIMASSA	
OH3LP	VOIMASSA	
OH3LPG	VOIMASSA	
OH3LQ	VOIMASSA	
OH3LQA	VOIMASSA	
OH3LQK	VOIMASSA	
OH3LQL	VOIMASSA	
OH3LQN	VOIMASSA	
OH3LQW	VOIMASSA	
OH3LR	VOIMASSA	
OH3LRT	VOIMASSA	
OH3LS	VOIMASSA	
OH3LSB	VOIMASSA	
OH3LTJ	VOIMASSA	
OH3LTX	VOIMASSA	
OH3LUK	VOIMASSA	
OH3LUL	VOIMASSA	
OH3LUU	VOIMASSA	
OH3LV	VOIMASSA	
OH3LW	KARENSSI	
OH3LVJ	VOIMASSA	
OH3LVO	VOIMASSA	
OH3LWP	VOIMASSA	
OH3LWR	VOIMASSA	
OH3LWS	VOIMASSA	
OH3LX	VOIMASSA	
OH3LXE	VOIMASSA	
OH3LXW	VOIMASSA	
OH3LYA	VOIMASSA	
OH3LYG	VOIMASSA	
OH3LZ	VOIMASSA	
OH3M	VOIMASSA	
OH3MA	VOIMASSA	
OH3MAF	VOIMASSA	
OH3MAG	VOIMASSA	
OH3MB	VOIMASSA	
OH3MBC	VOIMASSA	
OH3MBE	VOIMASSA	
OH3MBI	VOIMASSA	
OH3MC	VOIMASSA	
OH3MCK	VOIMASSA	
OH3MDN	VOIMASSA	
OH3ME	VOIMASSA	
OH3MEA	VOIMASSA	
OH3MEO	VOIMASSA	
OH3MEP	VOIMASSA	
OH3MEU	VOIMASSA	
OH3MF	VOIMASSA	
OH3MFQ	VOIMASSA	
OH3MFT	VOIMASSA	
OH3MH	VOIMASSA	
OH3MHA	VOIMASSA	
OH3MHY	VOIMASSA	
OH3MIG	VOIMASSA	
OH3MIKA	VOIMASSA	
OH3MIM	VOIMASSA	
OH3MIY	VOIMASSA	
OH3MJ	VOIMASSA	
OH3MJN	VOIMASSA	
OH3MJQ	VOIMASSA	
OH3MJT	VOIMASSA	
OH3MK	VOIMASSA	
OH3MKH	VOIMASSA	
OH3MM	VOIMASSA	
OH3MMF	VOIMASSA	
OH3MMW	VOIMASSA	
OH3MN	VOIMASSA	
OH3MNI	VOIMASSA	
OH3MNK	VOIMASSA	
OH3MNL	VOIMASSA	
OH3MOI	VOIMASSA	
OH3MOQ	VOIMASSA	
OH3MOT	VOIMASSA	
OH3MPB	VOIMASSA	
OH3MPL	VOIMASSA	
OH3MQU	VOIMASSA	
OH3MRB	VOIMASSA	
OH3MRC	VOIMASSA	
OH3MRJ	VOIMASSA	
OH3MRP	VOIMASSA	
OH3MS	VOIMASSA	
OH3MST	VOIMASSA	
OH3MTK	VOIMASSA	
OH3MU	VOIMASSA	
OH3MUB	VOIMASSA	
OH3MUQ	VOIMASSA	
OH3MWG	VOIMASSA	
OH3MWN	VOIMASSA	
OH3MVR	VOIMASSA	
OH3MVV	VOIMASSA	
OH3MWY	VOIMASSA	
OH3MVZ	VOIMASSA	
OH3MX	VOIMASSA	
OH3MXT	VOIMASSA	
OH3MY	VOIMASSA	
OH3MYD	VOIMASSA	
OH3MYI	VOIMASSA	
OH3MYN	VOIMASSA	
OH3MZ	VOIMASSA	
OH3MZH	VOIMASSA	
OH3MZT	VOIMASSA	
OH3N	VOIMASSA	
OH3NA	VOIMASSA	
OH3NAO	VOIMASSA	
OH3NAQ	VOIMASSA	
OH3NB	VOIMASSA	
OH3NCA	VOIMASSA	
OH3NCH	VOIMASSA	
OH3NCM	VOIMASSA	
OH3ND	VOIMASSA	
OH3NDH	VOIMASSA	
OH3NE	VOIMASSA	
OH3NFC	VOIMASSA	
OH3NFD	VOIMASSA	
OH3NFH	VOIMASSA	
OH3NGT	VOIMASSA	
OH3NH	KARENSSI	
OH3NHF	VOIMASSA	
OH3NHK	VOIMASSA	
OH3NI	VOIMASSA	
OH3NIP	VOIMASSA	
OH3NIS	VOIMASSA	
OH3NIV	VOIMASSA	
OH3NIX	VOIMASSA	
OH3NJC	VOIMASSA	
OH3NJZ	VOIMASSA	
OH3NK	VOIMASSA	
OH3NKK	VOIMASSA	
OH3NKN	VOIMASSA	
OH3NKT	VOIMASSA	
OH3NLH	VOIMASSA	
OH3NLP	VOIMASSA	
OH3NN	VOIMASSA	
OH3NNI	VOIMASSA	
OH3NOB	VOIMASSA	
OH3NOD	VOIMASSA	
OH3NOSE	VOIMASSA	
OH3NPI	VOIMASSA	
OH3NPN	VOIMASSA	
OH3NPO	VOIMASSA	
OH3NPS	VOIMASSA	
OH3NQZ	VOIMASSA	
OH3NRT	VOIMASSA	
OH3NSF	VOIMASSA	
OH3NSZ	VOIMASSA	
OH3NT	VOIMASSA	
OH3NTH	VOIMASSA	
OH3NTJ	VOIMASSA	
OH3NTK	VOIMASSA	
OH3NU	VOIMASSA	
OH3NUH	VOIMASSA	
OH3NUZ	VOIMASSA	
OH3NWD	VOIMASSA	
OH3NVK	VOIMASSA	
OH3NWQ	VOIMASSA	
OH3NX	VOIMASSA	
OH3NXD	VOIMASSA	
OH3NXN	VOIMASSA	
OH3NXT	VOIMASSA	
OH3NXW	VOIMASSA	
OH3NYB	VOIMASSA	
OH3NZC	VOIMASSA	
OH3NZN	VOIMASSA	
OH3NZW	VOIMASSA	
OH3OE	VOIMASSA	
OH3OJ	VOIMASSA	
OH3OK	VOIMASSA	
OH3OM	VOIMASSA	
OH3OP	VOIMASSA	
OH3OQ	VOIMASSA	
OH3OR	VOIMASSA	
OH3OS	VOIMASSA	
OH3OT	VOIMASSA	
OH3P	VOIMASSA	
OH3PC	VOIMASSA	
OH3PE	VOIMASSA	
OH3PF	VOIMASSA	
OH3PH	VOIMASSA	
OH3PHII	VOIMASSA	
OH3PJ	VOIMASSA	
OH3PM	VOIMASSA	
OH3PP	VOIMASSA	
OH3PV	VOIMASSA	
OH3PWR	VOIMASSA	
OH3PY	VOIMASSA	
OH3PYY	VOIMASSA	
OH3QH	VOIMASSA	
OH3QK	VOIMASSA	
OH3QL	VOIMASSA	
OH3QN	VOIMASSA	
OH3R	VOIMASSA	
OH3RA	VOIMASSA	
OH3RAA	VOIMASSA	
OH3RAC	VOIMASSA	
OH3RAMI	VOIMASSA	
OH3RAN	VOIMASSA	
OH3RAR	VOIMASSA	
OH3RB	VOIMASSA	
OH3RBD	VOIMASSA	
OH3RBE	VOIMASSA	
OH3RBR	VOIMASSA	
OH3RC	VOIMASSA	
OH3RCD	VOIMASSA	
OH3RDA	VOIMASSA	
OH3RDB	VOIMASSA	
OH3RDH	VOIMASSA	
OH3RDR	VOIMASSA	
OH3RF	VOIMASSA	
OH3RG	VOIMASSA	
OH3RL	VOIMASSA	
OH3RM	VOIMASSA	
OH3RNE	VOIMASSA	
OH3RP	VOIMASSA	
OH3RR	VOIMASSA	
OH3RS	VOIMASSA	
OH3RT	VOIMASSA	
OH3RTR	VOIMASSA	
OH3RU	KARENSSI	
OH3RUD	VOIMASSA	
OH3RUR	VOIMASSA	
OH3RUX	VOIMASSA	
OH3RV	VOIMASSA	
OH3RX	VOIMASSA	
OH3RY	VOIMASSA	
OH3SA	VOIMASSA	
OH3SAP	VOIMASSA	
OH3SD	VOIMASSA	
OH3SE	VOIMASSA	
OH3SF	VOIMASSA	
OH3SFC	VOIMASSA	
OH3SG	KARENSSI	
OH3SHF	VOIMASSA	
OH3SI	VOIMASSA	
OH3SK	VOIMASSA	
OH3SL	VOIMASSA	
OH3SM	VOIMASSA	
OH3SN	VOIMASSA	
OH3SO	VOIMASSA	
OH3SP	VOIMASSA	
OH3SPN	VOIMASSA	
OH3SQ	VOIMASSA	
OH3SR	VOIMASSA	
OH3SRT	VOIMASSA	
OH3SRT	KARENSSI	
OH3SS	VOIMASSA	
OH3ST	VOIMASSA	
OH3SU	KARENSSI	
OH3SUF	VOIMASSA	
OH3SUS	VOIMASSA	
OH3SUV	VOIMASSA	
OH3SV	VOIMASSA	
OH3SW	VOIMASSA	
OH3SX	VOIMASSA	
OH3T	VOIMASSA	
OH3TA	VOIMASSA	
OH3TAM	VOIMASSA	
OH3TB	VOIMASSA	
OH3TE	KARENSSI	
OH3TERO	VOIMASSA	
OH3TF	VOIMASSA	
OH3TG	VOIMASSA	
OH3TIA	VOIMASSA	
OH3TJM	VOIMASSA	
OH3TK	VOIMASSA	
OH3TKN	VOIMASSA	
OH3TKN	KARENSSI	
OH3TM	VOIMASSA	
OH3TMI	VOIMASSA	
OH3TN	VOIMASSA	
OH3TONI	VOIMASSA	
OH3TP	VOIMASSA	
OH3TR	VOIMASSA	
OH3TS	VOIMASSA	
OH3TU	VOIMASSA	
OH3TW	VOIMASSA	
OH3TX	VOIMASSA	
OH3TY	VOIMASSA	
OH3TZ	KARENSSI	
OH3UAD	VOIMASSA	
OH3UAE	VOIMASSA	
OH3UAF	VOIMASSA	
OH3UAG	VOIMASSA	
OH3UAH	VOIMASSA	
OH3UAI	VOIMASSA	
OH3UAJ	VOIMASSA	
OH3UAN	VOIMASSA	
OH3UAY	VOIMASSA	
OH3UBI	VOIMASSA	
OH3UBL	VOIMASSA	
OH3UBT	VOIMASSA	
OH3UBX	VOIMASSA	
OH3UCO	VOIMASSA	
OH3UCP	VOIMASSA	
OH3UCU	VOIMASSA	
OH3UDF	VOIMASSA	
OH3UDT	VOIMASSA	
OH3UE	VOIMASSA	
OH3UF	VOIMASSA	
OH3UO	KARENSSI	
OH3UP	VOIMASSA	
OH3UQ	VOIMASSA	
OH3UR	VOIMASSA	
OH3US	VOIMASSA	
OH3UT	VOIMASSA	
OH3UU	VOIMASSA	
OH3UW	VOIMASSA	
OH3W	VOIMASSA	
OH3VA	VOIMASSA	
OH3WA	KARENSSI	
OH3WAW	VOIMASSA	
OH3WB	VOIMASSA	
OH3VC	VOIMASSA	
OH3WD	VOIMASSA	
OH3VE	VOIMASSA	
OH3WE	VOIMASSA	
OH3WH	VOIMASSA	
OH3VHF	VOIMASSA	
OH3VHH	VOIMASSA	
OH3VIKI	VOIMASSA	
OH3WJ	VOIMASSA	
OH3WK	KARENSSI	
OH3VL	VOIMASSA	
OH3VN	VOIMASSA	
OH3WN	VOIMASSA	
OH3VO	VOIMASSA	
OH3WOLF	VOIMASSA	
OH3VP	VOIMASSA	
OH3VPS	VOIMASSA	
OH3WQ	VOIMASSA	
OH3VRT	VOIMASSA	
OH3WS	VOIMASSA	
OH3VT	VOIMASSA	
OH3WU	VOIMASSA	
OH3VV	VOIMASSA	
OH3WW	VOIMASSA	
OH3VX	VOIMASSA	
OH3VZ	VOIMASSA	
OH3X	VOIMASSA	
OH3XA	VOIMASSA	
OH3XB	VOIMASSA	
OH3XF	VOIMASSA	
OH3XH	VOIMASSA	
OH3XK	VOIMASSA	
OH3XM	VOIMASSA	
OH3XO	VOIMASSA	
OH3XP	VOIMASSA	
OH3XQ	VOIMASSA	
OH3XR	VOIMASSA	
OH3XS	VOIMASSA	
OH3XU	VOIMASSA	
OH3XW	VOIMASSA	
OH3XX	VOIMASSA	
OH3XY	VOIMASSA	
OH3XZ	VOIMASSA	
OH3YC	VOIMASSA	
OH3YG	VOIMASSA	
OH3YI	VOIMASSA	
OH3YL	VOIMASSA	
OH3YM	VOIMASSA	
OH3YN	VOIMASSA	
OH3YO	VOIMASSA	
OH3YP	VOIMASSA	
OH3YR	VOIMASSA	
OH3YS	VOIMASSA	
OH3YW	VOIMASSA	
OH3YX	VOIMASSA	
OH3YY	VOIMASSA	
OH3YZ	VOIMASSA	
OH3Z	VOIMASSA	
OH3ZA	VOIMASSA	
OH3ZG	KARENSSI	
OH3ZL	VOIMASSA	
OH3ZM	VOIMASSA	
OH3ZP	VOIMASSA	
OH3ZQ	VOIMASSA	
OH3ZR	VOIMASSA	
OH3ZS	VOIMASSA	
OH3ZU	VOIMASSA	
OH3ZV	VOIMASSA	
OH3ZZ	VOIMASSA	
OH44FF	VOIMASSA	
OH4A	VOIMASSA	
OH4AA	VOIMASSA	
OH4AB	VOIMASSA	
OH4AC	VOIMASSA	
OH4ACD	VOIMASSA	
OH4AZK	VOIMASSA	
OH4BBI	VOIMASSA	
OH4BBY	VOIMASSA	
OH4BCS	VOIMASSA	
OH4BEN	VOIMASSA	
OH4BJV	VOIMASSA	
OH4BJW	VOIMASSA	
OH4BM	VOIMASSA	
OH4BNK	VOIMASSA	
OH4BNP	VOIMASSA	
OH4BQN	VOIMASSA	
OH4BTF	VOIMASSA	
OH4BW	VOIMASSA	
OH4BZO	VOIMASSA	
OH4CCE	VOIMASSA	
OH4CCF	VOIMASSA	
OH4CEN	VOIMASSA	
OH4CFO	VOIMASSA	
OH4CNX	VOIMASSA	
OH4CW	VOIMASSA	
OH4DX	VOIMASSA	
OH4E	VOIMASSA	
OH4EA	VOIMASSA	
OH4EBD	VOIMASSA	
OH4EBE	VOIMASSA	
OH4ECY	VOIMASSA	
OH4ED	VOIMASSA	
OH4EEY	VOIMASSA	
OH4EF	VOIMASSA	
OH4EFB	VOIMASSA	
OH4EFU	VOIMASSA	
OH4EIJ	VOIMASSA	
OH4ELH	VOIMASSA	
OH4ELM	VOIMASSA	
OH4ERO	VOIMASSA	
OH4ERP	VOIMASSA	
OH4ERQ	VOIMASSA	
OH4ETC	VOIMASSA	
OH4ETO	VOIMASSA	
OH4ETP	VOIMASSA	
OH4ETV	VOIMASSA	
OH4EVX	VOIMASSA	
OH4FB	VOIMASSA	
OH4FLG	VOIMASSA	
OH4FQE	VOIMASSA	
OH4FR	VOIMASSA	
OH4FSK	VOIMASSA	
OH4FSL	VOIMASSA	
OH4FUN	VOIMASSA	
OH4FVB	VOIMASSA	
OH4FVC	VOIMASSA	
OH4FVD	VOIMASSA	
OH4FVE	VOIMASSA	
OH4GGE	VOIMASSA	
OH4GGW	VOIMASSA	
OH4GN	VOIMASSA	
OH4GQP	VOIMASSA	
OH4GRM	VOIMASSA	
OH4GTN	VOIMASSA	
OH4GVN	VOIMASSA	
OH4HAX	VOIMASSA	
OH4HCC	VOIMASSA	
OH4HD	VOIMASSA	
OH4HHG	VOIMASSA	
OH4HI	VOIMASSA	
OH4HIE	VOIMASSA	
OH4HJI	VOIMASSA	
OH4HK	VOIMASSA	
OH4HKX	VOIMASSA	
OH4HLJ	VOIMASSA	
OH4HLK	VOIMASSA	
OH4HLO	VOIMASSA	
OH4HMD	VOIMASSA	
OH4HMR	VOIMASSA	
OH4HNT	VOIMASSA	
OH4HQJ	VOIMASSA	
OH4HQV	VOIMASSA	
OH4HSO	VOIMASSA	
OH4HXK	VOIMASSA	
OH4II	VOIMASSA	
OH4JFN	VOIMASSA	
OH4JGE	VOIMASSA	
OH4JK	VOIMASSA	
OH4JL	VOIMASSA	
OH4JLV	VOIMASSA	
OH4JMR	VOIMASSA	
OH4JOU	VOIMASSA	
OH4JP	VOIMASSA	
OH4JPS	VOIMASSA	
OH4JPV	VOIMASSA	
OH4JPX	VOIMASSA	
OH4JPY	VOIMASSA	
OH4JQB	VOIMASSA	
OH4JQG	VOIMASSA	
OH4JR	KARENSSI	
OH4JT	VOIMASSA	
OH4JTS	VOIMASSA	
OH4JVC	VOIMASSA	
OH4JWQ	VOIMASSA	
OH4JXZ	VOIMASSA	
OH4JYB	VOIMASSA	
OH4JZJ	VOIMASSA	
OH4K	VOIMASSA	
OH4KA	VOIMASSA	
OH4KBC	VOIMASSA	
OH4KEC	VOIMASSA	
OH4KED	VOIMASSA	
OH4KHY	VOIMASSA	
OH4KIA	VOIMASSA	
OH4KJU	VOIMASSA	
OH4KJY	VOIMASSA	
OH4KLO	VOIMASSA	
OH4KM	VOIMASSA	
OH4KOL	VOIMASSA	
OH4KPN	VOIMASSA	
OH4KRN	VOIMASSA	
OH4KRO	VOIMASSA	
OH4KRX	VOIMASSA	
OH4KW	VOIMASSA	
OH4KVM	VOIMASSA	
OH4KZM	VOIMASSA	
OH4LA	VOIMASSA	
OH4LBX	VOIMASSA	
OH4LDR	VOIMASSA	
OH4LNT	VOIMASSA	
OH4LRP	VOIMASSA	
OH4LTQ	VOIMASSA	
OH4LWH	VOIMASSA	
OH4LVJ	VOIMASSA	
OH4LYX	VOIMASSA	
OH4M	VOIMASSA	
OH4MA	VOIMASSA	
OH4MAX	VOIMASSA	
OH4MCV	VOIMASSA	
OH4MDY	VOIMASSA	
OH4MEZ	VOIMASSA	
OH4MFA	VOIMASSA	
OH4MFB	VOIMASSA	
OH4MFC	VOIMASSA	
OH4MI	VOIMASSA	
OH4MJ	VOIMASSA	
OH4ML	VOIMASSA	
OH4MM	VOIMASSA	
OH4MP	VOIMASSA	
OH4MQP	VOIMASSA	
OH4MR	VOIMASSA	
OH4MS	VOIMASSA	
OH4MSJ	VOIMASSA	
OH4MVH	VOIMASSA	
OH4MWI	VOIMASSA	
OH4MZL	VOIMASSA	
OH4N	VOIMASSA	
OH4NDU	VOIMASSA	
OH4NJH	VOIMASSA	
OH4NK	VOIMASSA	
OH4NL	VOIMASSA	
OH4NM	VOIMASSA	
OH4NMT	VOIMASSA	
OH4NPB	KARENSSI	
OH4NQJ	VOIMASSA	
OH4NQK	VOIMASSA	
OH4NRS	VOIMASSA	
OH4NT	KARENSSI	
OH4NW	VOIMASSA	
OH4NWW	VOIMASSA	
OH4NVX	VOIMASSA	
OH4NX	VOIMASSA	
OH4NZF	VOIMASSA	
OH4NZI	VOIMASSA	
OH4O	VOIMASSA	
OH4OD	VOIMASSA	
OH4OT	KARENSSI	
OH4PI	VOIMASSA	
OH4PS	VOIMASSA	
OH4PT	VOIMASSA	
OH4PW	VOIMASSA	
OH4QB	VOIMASSA	
OH4QP	VOIMASSA	
OH4R	VOIMASSA	
OH4RA	VOIMASSA	
OH4RAB	VOIMASSA	
OH4RAC	VOIMASSA	
OH4RAF	VOIMASSA	
OH4RC	VOIMASSA	
OH4RD	VOIMASSA	
OH4RDC	VOIMASSA	
OH4RDD	VOIMASSA	
OH4RDS	VOIMASSA	
OH4RF	VOIMASSA	
OH4RL	VOIMASSA	
OH4RM	VOIMASSA	
OH4RN	VOIMASSA	
OH4RR	VOIMASSA	
OH4RUB	VOIMASSA	
OH4RUC	VOIMASSA	
OH4RW	VOIMASSA	
OH4SA	VOIMASSA	
OH4SE	VOIMASSA	
OH4SG	VOIMASSA	
OH4SJ	VOIMASSA	
OH4SK	VOIMASSA	
OH4SS	VOIMASSA	
OH4SSU	VOIMASSA	
OH4ST	VOIMASSA	
OH4SUF	VOIMASSA	
OH4TH	VOIMASSA	
OH4TK	VOIMASSA	
OH4TM	VOIMASSA	
OH4TOM	VOIMASSA	
OH4TP	VOIMASSA	
OH4TQ	VOIMASSA	
OH4TS	VOIMASSA	
OH4TT	VOIMASSA	
OH4TU	VOIMASSA	
OH4TY	VOIMASSA	
OH4TZ	VOIMASSA	
OH4UI	VOIMASSA	
OH4UR	VOIMASSA	
OH4UV	VOIMASSA	
OH4W	VOIMASSA	
OH4VA	VOIMASSA	
OH4VK	VOIMASSA	
OH4VL	VOIMASSA	
OH4WP	KARENSSI	
OH4VR	VOIMASSA	
OH4WW	VOIMASSA	
OH4X	VOIMASSA	
OH4XX	VOIMASSA	
OH4YA	VOIMASSA	
OH4YB	VOIMASSA	
OH4YP	VOIMASSA	
OH4YR	VOIMASSA	
OH4YS	VOIMASSA	
OH4YT	VOIMASSA	
OH4YU	KARENSSI	
OH4ZS	VOIMASSA	
OH5A	VOIMASSA	
OH5AA	VOIMASSA	
OH5AB	VOIMASSA	
OH5ABP	VOIMASSA	
OH5ACC	VOIMASSA	
OH5AD	VOIMASSA	
OH5ADB	VOIMASSA	
OH5AE	VOIMASSA	
OH5AG	VOIMASSA	
OH5AI	VOIMASSA	
OH5ASA	VOIMASSA	
OH5AZD	VOIMASSA	
OH5AZP	VOIMASSA	
OH5AZS	VOIMASSA	
OH5AZU	VOIMASSA	
OH5AZY	VOIMASSA	
OH5B	VOIMASSA	
OH5BA	VOIMASSA	
OH5BBA	VOIMASSA	
OH5BBB	VOIMASSA	
OH5BC	VOIMASSA	
OH5BD	VOIMASSA	
OH5BDU	VOIMASSA	
OH5BE	VOIMASSA	
OH5BGZ	VOIMASSA	
OH5BI	VOIMASSA	
OH5BK	VOIMASSA	
OH5BKA	VOIMASSA	
OH5BKJ	VOIMASSA	
OH5BKP	VOIMASSA	
OH5BKU	VOIMASSA	
OH5BM	VOIMASSA	
OH5BMI	VOIMASSA	
OH5BMK	VOIMASSA	
OH5BNZ	VOIMASSA	
OH5BPX	VOIMASSA	
OH5BQ	VOIMASSA	
OH5BRB	VOIMASSA	
OH5BRM	VOIMASSA	
OH5BUP	VOIMASSA	
OH5BW	VOIMASSA	
OH5BX	VOIMASSA	
OH5BZR	VOIMASSA	
OH5C	VOIMASSA	
OH5CDT	VOIMASSA	
OH5CEF	VOIMASSA	
OH5CEI	VOIMASSA	
OH5CFI	VOIMASSA	
OH5CFP	VOIMASSA	
OH5CGY	VOIMASSA	
OH5CHH	VOIMASSA	
OH5CW	VOIMASSA	
OH5CX	VOIMASSA	
OH5CY	VOIMASSA	
OH5CZ	VOIMASSA	
OH5D	VOIMASSA	
OH5DA	VOIMASSA	
OH5DM	VOIMASSA	
OH5DMRA	VOIMASSA	
OH5DQ	VOIMASSA	
OH5DX	VOIMASSA	
OH5E	VOIMASSA	
OH5EAB	VOIMASSA	
OH5EAZ	VOIMASSA	
OH5EBB	VOIMASSA	
OH5EBC	VOIMASSA	
OH5ECD	VOIMASSA	
OH5ECJ	VOIMASSA	
OH5EDJ	VOIMASSA	
OH5EDP	VOIMASSA	
OH5EDQ	VOIMASSA	
OH5EE	VOIMASSA	
OH5EEF	VOIMASSA	
OH5EGT	VOIMASSA	
OH5EH	VOIMASSA	
OH5EHE	VOIMASSA	
OH5EIL	VOIMASSA	
OH5EIM	VOIMASSA	
OH5EIU	VOIMASSA	
OH5EJO	VOIMASSA	
OH5ELO	VOIMASSA	
OH5ELP	VOIMASSA	
OH5ELV	VOIMASSA	
OH5ELX	VOIMASSA	
OH5EMA	VOIMASSA	
OH5EMB	VOIMASSA	
OH5EOQ	VOIMASSA	
OH5EP	VOIMASSA	
OH5EPD	VOIMASSA	
OH5EQB	VOIMASSA	
OH5ERS	VOIMASSA	
OH5ERT	VOIMASSA	
OH5ERW	VOIMASSA	
OH5ES	VOIMASSA	
OH5ESF	VOIMASSA	
OH5ESU	VOIMASSA	
OH5ET	VOIMASSA	
OH5EUY	VOIMASSA	
OH5EWQ	VOIMASSA	
OH5FA	VOIMASSA	
OH5FAS	VOIMASSA	
OH5FAU	VOIMASSA	
OH5FBI	VOIMASSA	
OH5FCO	VOIMASSA	
OH5FED	VOIMASSA	
OH5FFE	VOIMASSA	
OH5FFG	VOIMASSA	
OH5FFT	VOIMASSA	
OH5FI	VOIMASSA	
OH5FM	VOIMASSA	
OH5FMW	VOIMASSA	
OH5FMX	VOIMASSA	
OH5FN	VOIMASSA	
OH5FNA	VOIMASSA	
OH5FNG	VOIMASSA	
OH5FOH	VOIMASSA	
OH5FP	VOIMASSA	
OH5FQT	VOIMASSA	
OH5FRJ	VOIMASSA	
OH5FSI	VOIMASSA	
OH5FSZ	VOIMASSA	
OH5FTN	VOIMASSA	
OH5FUC	VOIMASSA	
OH5FWA	VOIMASSA	
OH5FWB	VOIMASSA	
OH5FWL	VOIMASSA	
OH5FVM	VOIMASSA	
OH5FWM	VOIMASSA	
OH5FWO	VOIMASSA	
OH5FVY	VOIMASSA	
OH5FXO	VOIMASSA	
OH5FZK	VOIMASSA	
OH5GAS	VOIMASSA	
OH5GBB	VOIMASSA	
OH5GCZ	VOIMASSA	
OH5GDN	VOIMASSA	
OH5GDS	VOIMASSA	
OH5GE	VOIMASSA	
OH5GES	VOIMASSA	
OH5GHP	VOIMASSA	
OH5GIO	VOIMASSA	
OH5GJH	VOIMASSA	
OH5GJU	VOIMASSA	
OH5GJZ	VOIMASSA	
OH5GLW	VOIMASSA	
OH5GMB	VOIMASSA	
OH5GOE	VOIMASSA	
OH5GOW	VOIMASSA	
OH5GPN	VOIMASSA	
OH5GQF	VOIMASSA	
OH5GQG	VOIMASSA	
OH5GQI	VOIMASSA	
OH5GWF	VOIMASSA	
OH5GVI	VOIMASSA	
OH5GXS	VOIMASSA	
OH5GYM	VOIMASSA	
OH5GZI	VOIMASSA	
OH5GZJ	VOIMASSA	
OH5GZL	VOIMASSA	
OH5GZR	VOIMASSA	
OH5HBA	VOIMASSA	
OH5HBP	VOIMASSA	
OH5HBV	VOIMASSA	
OH5HCJ	VOIMASSA	
OH5HDN	VOIMASSA	
OH5HFT	VOIMASSA	
OH5HGJ	VOIMASSA	
OH5HHD	VOIMASSA	
OH5HKW	VOIMASSA	
OH5HLL	VOIMASSA	
OH5HM	VOIMASSA	
OH5HMG	VOIMASSA	
OH5HMV	VOIMASSA	
OH5HNA	VOIMASSA	
OH5HNK	VOIMASSA	
OH5HPC	VOIMASSA	
OH5HQN	VOIMASSA	
OH5HQO	VOIMASSA	
OH5HQQ	VOIMASSA	
OH5HRM	VOIMASSA	
OH5HUR	VOIMASSA	
OH5HUZ	VOIMASSA	
OH5HVB	VOIMASSA	
OH5HVF	VOIMASSA	
OH5HVG	VOIMASSA	
OH5HVH	VOIMASSA	
OH5HVI	VOIMASSA	
OH5HVN	VOIMASSA	
OH5HXL	VOIMASSA	
OH5HZI	VOIMASSA	
OH5IE	VOIMASSA	
OH5IY	VOIMASSA	
OH5JAE	VOIMASSA	
OH5JAH	VOIMASSA	
OH5JAU	VOIMASSA	
OH5JBH	VOIMASSA	
OH5JBI	VOIMASSA	
OH5JCA	VOIMASSA	
OH5JCN	VOIMASSA	
OH5JD	VOIMASSA	
OH5JDI	VOIMASSA	
OH5JDR	VOIMASSA	
OH5JEI	VOIMASSA	
OH5JEK	VOIMASSA	
OH5JFM	VOIMASSA	
OH5JGO	VOIMASSA	
OH5JJF	VOIMASSA	
OH5JJL	VOIMASSA	
OH5JK	VOIMASSA	
OH5JLS	VOIMASSA	
OH5JMI	VOIMASSA	
OH5JMP	VOIMASSA	
OH5JN	VOIMASSA	
OH5JOC	VOIMASSA	
OH5JOH	VOIMASSA	
OH5JOO	VOIMASSA	
OH5JP	VOIMASSA	
OH5JTD	VOIMASSA	
OH5JTI	VOIMASSA	
OH5JUN	VOIMASSA	
OH5JXD	VOIMASSA	
OH5JXO	VOIMASSA	
OH5JXT	VOIMASSA	
OH5JYU	VOIMASSA	
OH5JYX	VOIMASSA	
OH5JZP	VOIMASSA	
OH5K	VOIMASSA	
OH5KA	VOIMASSA	
OH5KAY	VOIMASSA	
OH5KB	VOIMASSA	
OH5KBA	VOIMASSA	
OH5KBD	VOIMASSA	
OH5KBH	VOIMASSA	
OH5KC	VOIMASSA	
OH5KCP	VOIMASSA	
OH5KDL	VOIMASSA	
OH5KE	KARENSSI	
OH5KEU	VOIMASSA	
OH5KFJ	VOIMASSA	
OH5KFP	VOIMASSA	
OH5KGI	VOIMASSA	
OH5KH	KARENSSI	
OH5KIZ	VOIMASSA	
OH5KJI	VOIMASSA	
OH5KJQ	VOIMASSA	
OH5KJR	VOIMASSA	
OH5KKA	VOIMASSA	
OH5KKE	VOIMASSA	
OH5KLK	VOIMASSA	
OH5KM	VOIMASSA	
OH5KNE	VOIMASSA	
OH5KNG	VOIMASSA	
OH5KO	VOIMASSA	
OH5KOA	VOIMASSA	
OH5KOE	VOIMASSA	
OH5KOW	VOIMASSA	
OH5KP	VOIMASSA	
OH5KPF	VOIMASSA	
OH5KPQ	VOIMASSA	
OH5KQY	VOIMASSA	
OH5KR	VOIMASSA	
OH5KRI	VOIMASSA	
OH5KRQ	VOIMASSA	
OH5KS	VOIMASSA	
OH5KSJ	VOIMASSA	
OH5KT	VOIMASSA	
OH5KTE	VOIMASSA	
OH5KTF	VOIMASSA	
OH5KTW	VOIMASSA	
OH5KU	VOIMASSA	
OH5KUH	VOIMASSA	
OH5KUY	VOIMASSA	
OH5KV	VOIMASSA	
OH5KW	VOIMASSA	
OH5KWA	VOIMASSA	
OH5KVG	VOIMASSA	
OH5KVN	VOIMASSA	
OH5KYX	VOIMASSA	
OH5KYY	VOIMASSA	
OH5KZ	VOIMASSA	
OH5KZW	VOIMASSA	
OH5LAB	VOIMASSA	
OH5LAM	VOIMASSA	
OH5LAP	VOIMASSA	
OH5LAQ	VOIMASSA	
OH5LBR	VOIMASSA	
OH5LC	VOIMASSA	
OH5LCJ	VOIMASSA	
OH5LE	VOIMASSA	
OH5LEF	VOIMASSA	
OH5LEJ	VOIMASSA	
OH5LEP	VOIMASSA	
OH5LF	VOIMASSA	
OH5LFT	VOIMASSA	
OH5LHJ	VOIMASSA	
OH5LHK	VOIMASSA	
OH5LHM	VOIMASSA	
OH5LID	VOIMASSA	
OH5LIZ	VOIMASSA	
OH5LJT	VOIMASSA	
OH5LK	VOIMASSA	
OH5LKE	VOIMASSA	
OH5LLD	VOIMASSA	
OH5LLR	VOIMASSA	
OH5LMU	VOIMASSA	
OH5LMV	VOIMASSA	
OH5LMZ	VOIMASSA	
OH5LN	VOIMASSA	
OH5LNK	VOIMASSA	
OH5LOF	VOIMASSA	
OH5LP	VOIMASSA	
OH5LQ	VOIMASSA	
OH5LQQ	VOIMASSA	
OH5LUQ	VOIMASSA	
OH5LW	VOIMASSA	
OH5LX	VOIMASSA	
OH5LXK	VOIMASSA	
OH5LZ	VOIMASSA	
OH5M	VOIMASSA	
OH5MA	VOIMASSA	
OH5MC	VOIMASSA	
OH5MD	VOIMASSA	
OH5MDE	VOIMASSA	
OH5ME	VOIMASSA	
OH5MES	VOIMASSA	
OH5MFJ	VOIMASSA	
OH5MFM	VOIMASSA	
OH5MFW	VOIMASSA	
OH5MGD	VOIMASSA	
OH5MJ	VOIMASSA	
OH5ML	VOIMASSA	
OH5MLF	VOIMASSA	
OH5MLH	VOIMASSA	
OH5MM	VOIMASSA	
OH5MMG	VOIMASSA	
OH5MMO	VOIMASSA	
OH5MMZ	VOIMASSA	
OH5MNG	VOIMASSA	
OH5MNH	VOIMASSA	
OH5MNJ	VOIMASSA	
OH5MNN	VOIMASSA	
OH5MPA	VOIMASSA	
OH5MPD	VOIMASSA	
OH5MPE	VOIMASSA	
OH5MPZ	VOIMASSA	
OH5MQ	VOIMASSA	
OH5MRM	VOIMASSA	
OH5MTH	VOIMASSA	
OH5MU	VOIMASSA	
OH5MUK	VOIMASSA	
OH5MWL	VOIMASSA	
OH5MVQ	VOIMASSA	
OH5MWR	VOIMASSA	
OH5MWZ	VOIMASSA	
OH5MX	VOIMASSA	
OH5MXQ	VOIMASSA	
OH5MXW	VOIMASSA	
OH5MYB	VOIMASSA	
OH5MZG	VOIMASSA	
OH5MZS	VOIMASSA	
OH5MZZ	VOIMASSA	
OH5NBJ	VOIMASSA	
OH5NCG	VOIMASSA	
OH5NCY	VOIMASSA	
OH5NE	VOIMASSA	
OH5NEG	VOIMASSA	
OH5NG	VOIMASSA	
OH5NI	VOIMASSA	
OH5NK	VOIMASSA	
OH5NLX	VOIMASSA	
OH5NN	VOIMASSA	
OH5NOL	VOIMASSA	
OH5NP	VOIMASSA	
OH5NQ	VOIMASSA	
OH5NS	VOIMASSA	
OH5NSH	VOIMASSA	
OH5NSV	VOIMASSA	
OH5NTV	VOIMASSA	
OH5NUD	VOIMASSA	
OH5NUU	VOIMASSA	
OH5NW	VOIMASSA	
OH5NWT	VOIMASSA	
OH5NXO	VOIMASSA	
OH5NYN	VOIMASSA	
OH5NZ	VOIMASSA	
OH5NZM	VOIMASSA	
OH5NZO	VOIMASSA	
OH5O	VOIMASSA	
OH5OI	VOIMASSA	
OH5OS	VOIMASSA	
OH5PA	KARENSSI	
OH5PW	VOIMASSA	
OH5QB	VOIMASSA	
OH5QD	VOIMASSA	
OH5QF	VOIMASSA	
OH5QH	VOIMASSA	
OH5QI	VOIMASSA	
OH5QK	VOIMASSA	
OH5QN	VOIMASSA	
OH5QW	VOIMASSA	
OH5QY	VOIMASSA	
OH5R	VOIMASSA	
OH5RAB	VOIMASSA	
OH5RAC	VOIMASSA	
OH5RB	VOIMASSA	
OH5RBG	VOIMASSA	
OH5RC	VOIMASSA	
OH5RDC	VOIMASSA	
OH5RDF	VOIMASSA	
OH5RF	VOIMASSA	
OH5RM	VOIMASSA	
OH5RO	VOIMASSA	
OH5RP	VOIMASSA	
OH5RR	VOIMASSA	
OH5RUA	VOIMASSA	
OH5RUB	VOIMASSA	
OH5RUD	VOIMASSA	
OH5RUG	VOIMASSA	
OH5RUM	VOIMASSA	
OH5RX	VOIMASSA	
OH5S	VOIMASSA	
OH5SA	VOIMASSA	
OH5SB	VOIMASSA	
OH5SC	VOIMASSA	
OH5SE	VOIMASSA	
OH5SH	VOIMASSA	
OH5SS	VOIMASSA	
OH5ST	VOIMASSA	
OH5SUF	VOIMASSA	
OH5SV	VOIMASSA	
OH5SW	VOIMASSA	
OH5SY	VOIMASSA	
OH5T	VOIMASSA	
OH5TA	VOIMASSA	
OH5TB	VOIMASSA	
OH5TEG	VOIMASSA	
OH5TEN	VOIMASSA	
OH5TJ	VOIMASSA	
OH5TK	VOIMASSA	
OH5TL	VOIMASSA	
OH5TM	VOIMASSA	
OH5TN	VOIMASSA	
OH5TPO	VOIMASSA	
OH5TQ	VOIMASSA	
OH5TS	VOIMASSA	
OH5TV	VOIMASSA	
OH5TZ	VOIMASSA	
OH5U	VOIMASSA	
OH5UDB	VOIMASSA	
OH5UFO	VOIMASSA	
OH5UL	KARENSSI	
OH5UM	VOIMASSA	
OH5UO	VOIMASSA	
OH5UQ	VOIMASSA	
OH5UU	VOIMASSA	
OH5UV	VOIMASSA	
OH5UW	VOIMASSA	
OH5UX	VOIMASSA	
OH5VA	VOIMASSA	
OH5WD	VOIMASSA	
OH5VE	VOIMASSA	
OH5VG	VOIMASSA	
OH5VH	VOIMASSA	
OH5WH	VOIMASSA	
OH5VM	VOIMASSA	
OH5WM	VOIMASSA	
OH5WO	VOIMASSA	
OH5WP	VOIMASSA	
OH5VS	VOIMASSA	
OH5WS	VOIMASSA	
OH5VT	VOIMASSA	
OH5WTM	VOIMASSA	
OH5WU	VOIMASSA	
OH5WW	VOIMASSA	
OH5VX	VOIMASSA	
OH5VY	VOIMASSA	
OH5WY	VOIMASSA	
OH5X	VOIMASSA	
OH5XA	VOIMASSA	
OH5XB	VOIMASSA	
OH5XE	VOIMASSA	
OH5XH	VOIMASSA	
OH5XK	VOIMASSA	
OH5XL	VOIMASSA	
OH5XN	VOIMASSA	
OH5XO	VOIMASSA	
OH5XP	VOIMASSA	
OH5XX	VOIMASSA	
OH5Y	VOIMASSA	
OH5YA	VOIMASSA	
OH5YE	VOIMASSA	
OH5YI	VOIMASSA	
OH5YP	VOIMASSA	
OH5YR	VOIMASSA	
OH5YU	VOIMASSA	
OH5YW	VOIMASSA	
OH5YX	VOIMASSA	
OH5YY	VOIMASSA	
OH5YZ	VOIMASSA	
OH5Z	VOIMASSA	
OH5ZA	VOIMASSA	
OH5ZB	VOIMASSA	
OH5ZF	VOIMASSA	
OH5ZG	VOIMASSA	
OH5ZJ	VOIMASSA	
OH5ZK	VOIMASSA	
OH5ZN	VOIMASSA	
OH5ZO	VOIMASSA	
OH5ZU	VOIMASSA	
OH5ZX	VOIMASSA	
OH5ZY	VOIMASSA	
OH5ZZ	VOIMASSA	
OH64K	VOIMASSA	
OH659JT	VOIMASSA	
OH6A	VOIMASSA	
OH6AA	VOIMASSA	
OH6AAD	VOIMASSA	
OH6ABA	VOIMASSA	
OH6AC	VOIMASSA	
OH6AD	VOIMASSA	
OH6ADHD	VOIMASSA	
OH6AG	VOIMASSA	
OH6AH	VOIMASSA	
OH6AI	VOIMASSA	
OH6AK	VOIMASSA	
OH6ALPO	VOIMASSA	
OH6AN	VOIMASSA	
OH6AP	VOIMASSA	
OH6AR	VOIMASSA	
OH6AS	KARENSSI	
OH6AT	VOIMASSA	
OH6AW	VOIMASSA	
OH6AWB	VOIMASSA	
OH6AWE	VOIMASSA	
OH6AWN	VOIMASSA	
OH6AX	VOIMASSA	
OH6AYA	VOIMASSA	
OH6AYW	VOIMASSA	
OH6AYY	VOIMASSA	
OH6AZS	VOIMASSA	
OH6AZT	VOIMASSA	
OH6B	VOIMASSA	
OH6BA	VOIMASSA	
OH6BD	VOIMASSA	
OH6BDR	VOIMASSA	
OH6BER	VOIMASSA	
OH6BEX	VOIMASSA	
OH6BFW	VOIMASSA	
OH6BG	VOIMASSA	
OH6BHJ	VOIMASSA	
OH6BHZ	VOIMASSA	
OH6BI	VOIMASSA	
OH6BJZ	VOIMASSA	
OH6BKO	VOIMASSA	
OH6BL	VOIMASSA	
OH6BM	VOIMASSA	
OH6BMF	VOIMASSA	
OH6BNV	VOIMASSA	
OH6BOD	VOIMASSA	
OH6BPL	VOIMASSA	
OH6BQH	VOIMASSA	
OH6BQL	VOIMASSA	
OH6BR	KARENSSI	
OH6BRO	VOIMASSA	
OH6BRQ	VOIMASSA	
OH6BVP	VOIMASSA	
OH6BX	VOIMASSA	
OH6BY	VOIMASSA	
OH6BZ	VOIMASSA	
OH6BZC	VOIMASSA	
OH6C	VOIMASSA	
OH6CAC	VOIMASSA	
OH6CAY	VOIMASSA	
OH6CBM	VOIMASSA	
OH6CCB	VOIMASSA	
OH6CCC	VOIMASSA	
OH6CCH	VOIMASSA	
OH6CCY	VOIMASSA	
OH6CE	VOIMASSA	
OH6CEC	VOIMASSA	
OH6CER	VOIMASSA	
OH6CF	VOIMASSA	
OH6CFF	VOIMASSA	
OH6CFJ	VOIMASSA	
OH6CGH	VOIMASSA	
OH6CGX	VOIMASSA	
OH6CH	VOIMASSA	
OH6CHE	VOIMASSA	
OH6CI	VOIMASSA	
OH6CJ	VOIMASSA	
OH6CK	VOIMASSA	
OH6CL	VOIMASSA	
OH6CM	VOIMASSA	
OH6CN	VOIMASSA	
OH6CQ	VOIMASSA	
OH6CR	VOIMASSA	
OH6CS	VOIMASSA	
OH6CT	VOIMASSA	
OH6CU	VOIMASSA	
OH6CV	VOIMASSA	
OH6CW	VOIMASSA	
OH6CY	VOIMASSA	
OH6D	VOIMASSA	
OH6DAF	VOIMASSA	
OH6DB	VOIMASSA	
OH6DC	VOIMASSA	
OH6DD	VOIMASSA	
OH6DDR	VOIMASSA	
OH6DE	VOIMASSA	
OH6DF	VOIMASSA	
OH6DH	VOIMASSA	
OH6DK	VOIMASSA	
OH6DL	VOIMASSA	
OH6DM	VOIMASSA	
OH6DMR	VOIMASSA	
OH6DN	VOIMASSA	
OH6DO	VOIMASSA	
OH6DQ	VOIMASSA	
OH6DT	VOIMASSA	
OH6DU	VOIMASSA	
OH6DV	VOIMASSA	
OH6DX	VOIMASSA	
OH6DY	VOIMASSA	
OH6DZ	VOIMASSA	
OH6E	VOIMASSA	
OH6EA	VOIMASSA	
OH6EAC	VOIMASSA	
OH6ECF	VOIMASSA	
OH6ECH	VOIMASSA	
OH6ECL	VOIMASSA	
OH6ECM	VOIMASSA	
OH6ECO	VOIMASSA	
OH6ECP	VOIMASSA	
OH6ECV	VOIMASSA	
OH6EDD	VOIMASSA	
OH6EDO	VOIMASSA	
OH6EDW	VOIMASSA	
OH6EDX	VOIMASSA	
OH6EDY	VOIMASSA	
OH6EDZ	VOIMASSA	
OH6EEA	VOIMASSA	
OH6EEC	VOIMASSA	
OH6EF	VOIMASSA	
OH6EFH	VOIMASSA	
OH6EFX	VOIMASSA	
OH6EFY	VOIMASSA	
OH6EGC	VOIMASSA	
OH6EH	VOIMASSA	
OH6EHQ	VOIMASSA	
OH6EHZ	VOIMASSA	
OH6EI	VOIMASSA	
OH6EIH	VOIMASSA	
OH6EIV	VOIMASSA	
OH6EJD	VOIMASSA	
OH6EJF	VOIMASSA	
OH6EJG	VOIMASSA	
OH6EJI	VOIMASSA	
OH6EJL	VOIMASSA	
OH6EJN	VOIMASSA	
OH6EJZ	VOIMASSA	
OH6EKJ	VOIMASSA	
OH6EKR	VOIMASSA	
OH6EKS	VOIMASSA	
OH6EKW	VOIMASSA	
OH6EKX	VOIMASSA	
OH6ELD	VOIMASSA	
OH6ELF	VOIMASSA	
OH6ELN	VOIMASSA	
OH6EMV	VOIMASSA	
OH6EMZ	VOIMASSA	
OH6EOD	VOIMASSA	
OH6EOG	VOIMASSA	
OH6EOL	VOIMASSA	
OH6EP	VOIMASSA	
OH6EPM	VOIMASSA	
OH6EQC	VOIMASSA	
OH6EQE	VOIMASSA	
OH6ESH	VOIMASSA	
OH6ESK	VOIMASSA	
OH6ETF	VOIMASSA	
OH6ETS	VOIMASSA	
OH6ETT	VOIMASSA	
OH6ETY	VOIMASSA	
OH6EUL	VOIMASSA	
OH6EUM	VOIMASSA	
OH6EV	VOIMASSA	
OH6EWA	VOIMASSA	
OH6EWD	VOIMASSA	
OH6EWU	VOIMASSA	
OH6EX	VOIMASSA	
OH6EXA	VOIMASSA	
OH6EXB	VOIMASSA	
OH6EXW	VOIMASSA	
OH6EYG	VOIMASSA	
OH6EYJ	VOIMASSA	
OH6EYK	VOIMASSA	
OH6EYL	VOIMASSA	
OH6EYM	VOIMASSA	
OH6EYN	VOIMASSA	
OH6EYP	VOIMASSA	
OH6EYV	VOIMASSA	
OH6EYW	VOIMASSA	
OH6EZD	VOIMASSA	
OH6EZF	VOIMASSA	
OH6EZU	VOIMASSA	
OH6EZZ	VOIMASSA	
OH6F	VOIMASSA	
OH6FA	VOIMASSA	
OH6FB	VOIMASSA	
OH6FBB	VOIMASSA	
OH6FBF	VOIMASSA	
OH6FBW	VOIMASSA	
OH6FCM	VOIMASSA	
OH6FCS	VOIMASSA	
OH6FDB	VOIMASSA	
OH6FDK	VOIMASSA	
OH6FDM	VOIMASSA	
OH6FDR	VOIMASSA	
OH6FEA	VOIMASSA	
OH6FFR	VOIMASSA	
OH6FFZ	VOIMASSA	
OH6FGF	VOIMASSA	
OH6FGH	VOIMASSA	
OH6FH	VOIMASSA	
OH6FHW	VOIMASSA	
OH6FHX	VOIMASSA	
OH6FI	VOIMASSA	
OH6FIJ	VOIMASSA	
OH6FJA	VOIMASSA	
OH6FJB	VOIMASSA	
OH6FJF	VOIMASSA	
OH6FJG	VOIMASSA	
OH6FJI	VOIMASSA	
OH6FJJ	VOIMASSA	
OH6FJN	VOIMASSA	
OH6FJS	VOIMASSA	
OH6FJT	VOIMASSA	
OH6FKI	VOIMASSA	
OH6FKO	VOIMASSA	
OH6FLC	VOIMASSA	
OH6FLE	VOIMASSA	
OH6FME	VOIMASSA	
OH6FMG	VOIMASSA	
OH6FN	VOIMASSA	
OH6FOR	VOIMASSA	
OH6FPD	VOIMASSA	
OH6FQ	VOIMASSA	
OH6FQI	VOIMASSA	
OH6FQL	VOIMASSA	
OH6FRP	VOIMASSA	
OH6FRR	VOIMASSA	
OH6FRS	VOIMASSA	
OH6FS	VOIMASSA	
OH6FSC	VOIMASSA	
OH6FSD	VOIMASSA	
OH6FSE	VOIMASSA	
OH6FSF	VOIMASSA	
OH6FSG	VOIMASSA	
OH6FSO	VOIMASSA	
OH6FSP	VOIMASSA	
OH6FSQ	VOIMASSA	
OH6FSV	VOIMASSA	
OH6FT	VOIMASSA	
OH6FTE	VOIMASSA	
OH6FTR	VOIMASSA	
OH6FTZ	VOIMASSA	
OH6FUB	VOIMASSA	
OH6FUO	VOIMASSA	
OH6FUU	VOIMASSA	
OH6FUY	VOIMASSA	
OH6FV	VOIMASSA	
OH6FW	VOIMASSA	
OH6FVA	VOIMASSA	
OH6FWV	VOIMASSA	
OH6FXB	VOIMASSA	
OH6FXH	VOIMASSA	
OH6FXL	VOIMASSA	
OH6FXM	VOIMASSA	
OH6FXP	VOIMASSA	
OH6FXV	VOIMASSA	
OH6FXW	VOIMASSA	
OH6FXY	VOIMASSA	
OH6FXZ	VOIMASSA	
OH6FYC	VOIMASSA	
OH6FYP	VOIMASSA	
OH6FYQ	VOIMASSA	
OH6FYR	VOIMASSA	
OH6FYS	VOIMASSA	
OH6FYU	VOIMASSA	
OH6FYV	VOIMASSA	
OH6FYW	VOIMASSA	
OH6FYX	VOIMASSA	
OH6FZF	VOIMASSA	
OH6G	VOIMASSA	
OH6GAF	VOIMASSA	
OH6GAG	VOIMASSA	
OH6GAP	VOIMASSA	
OH6GAR	VOIMASSA	
OH6GAW	VOIMASSA	
OH6GAZ	VOIMASSA	
OH6GBG	VOIMASSA	
OH6GBU	VOIMASSA	
OH6GD	VOIMASSA	
OH6GDX	VOIMASSA	
OH6GE	VOIMASSA	
OH6GEP	VOIMASSA	
OH6GEW	VOIMASSA	
OH6GF	VOIMASSA	
OH6GFF	VOIMASSA	
OH6GFG	VOIMASSA	
OH6GFI	VOIMASSA	
OH6GFO	VOIMASSA	
OH6GFR	VOIMASSA	
OH6GFV	VOIMASSA	
OH6GGB	VOIMASSA	
OH6GGI	VOIMASSA	
OH6GGL	VOIMASSA	
OH6GGV	VOIMASSA	
OH6GHF	VOIMASSA	
OH6GHI	VOIMASSA	
OH6GHV	VOIMASSA	
OH6GHX	VOIMASSA	
OH6GI	VOIMASSA	
OH6GIH	VOIMASSA	
OH6GJ	VOIMASSA	
OH6GJA	VOIMASSA	
OH6GJB	VOIMASSA	
OH6GJD	VOIMASSA	
OH6GJW	VOIMASSA	
OH6GKH	VOIMASSA	
OH6GKI	VOIMASSA	
OH6GKJ	VOIMASSA	
OH6GKM	VOIMASSA	
OH6GKW	VOIMASSA	
OH6GL	VOIMASSA	
OH6GLN	VOIMASSA	
OH6GM	VOIMASSA	
OH6GMD	VOIMASSA	
OH6GMT	VOIMASSA	
OH6GMU	VOIMASSA	
OH6GMX	VOIMASSA	
OH6GMY	VOIMASSA	
OH6GN	VOIMASSA	
OH6GNA	VOIMASSA	
OH6GNM	VOIMASSA	
OH6GO	VOIMASSA	
OH6GON	VOIMASSA	
OH6GP	VOIMASSA	
OH6GPB	VOIMASSA	
OH6GPP	VOIMASSA	
OH6GPT	VOIMASSA	
OH6GPY	VOIMASSA	
OH6GQ	KARENSSI	
OH6GQR	VOIMASSA	
OH6GQS	VOIMASSA	
OH6GR	VOIMASSA	
OH6GRE	VOIMASSA	
OH6GRW	VOIMASSA	
OH6GRX	VOIMASSA	
OH6GSB	VOIMASSA	
OH6GSE	VOIMASSA	
OH6GSF	VOIMASSA	
OH6GSI	VOIMASSA	
OH6GSL	VOIMASSA	
OH6GSN	VOIMASSA	
OH6GSR	VOIMASSA	
OH6GT	VOIMASSA	
OH6GTH	VOIMASSA	
OH6GTI	VOIMASSA	
OH6GTR	VOIMASSA	
OH6GTX	VOIMASSA	
OH6GUA	VOIMASSA	
OH6GUQ	VOIMASSA	
OH6GUW	VOIMASSA	
OH6GWI	VOIMASSA	
OH6GWS	VOIMASSA	
OH6GWT	VOIMASSA	
OH6GX	VOIMASSA	
OH6GXZ	VOIMASSA	
OH6GYA	VOIMASSA	
OH6GYI	VOIMASSA	
OH6GYJ	VOIMASSA	
OH6GYL	VOIMASSA	
OH6GYZ	VOIMASSA	
OH6GZ	VOIMASSA	
OH6GZA	VOIMASSA	
OH6GZB	VOIMASSA	
OH6GZD	VOIMASSA	
OH6GZG	VOIMASSA	
OH6GZM	VOIMASSA	
OH6GZT	VOIMASSA	
OH6HAM	VOIMASSA	
OH6HAO	VOIMASSA	
OH6HAT	VOIMASSA	
OH6HAY	VOIMASSA	
OH6HBC	VOIMASSA	
OH6HBL	VOIMASSA	
OH6HC	VOIMASSA	
OH6HCE	VOIMASSA	
OH6HCG	VOIMASSA	
OH6HCQ	VOIMASSA	
OH6HCV	VOIMASSA	
OH6HD	VOIMASSA	
OH6HDB	VOIMASSA	
OH6HEKA	VOIMASSA	
OH6HFH	VOIMASSA	
OH6HFJ	VOIMASSA	
OH6HFL	VOIMASSA	
OH6HFM	VOIMASSA	
OH6HFO	VOIMASSA	
OH6HFQ	VOIMASSA	
OH6HFW	VOIMASSA	
OH6HFX	VOIMASSA	
OH6HG	VOIMASSA	
OH6HGA	VOIMASSA	
OH6HGD	VOIMASSA	
OH6HGN	VOIMASSA	
OH6HGW	VOIMASSA	
OH6HGY	VOIMASSA	
OH6HGZ	VOIMASSA	
OH6HH	VOIMASSA	
OH6HHE	VOIMASSA	
OH6HHS	VOIMASSA	
OH6HI	VOIMASSA	
OH6HIJ	VOIMASSA	
OH6HIK	VOIMASSA	
OH6HIN	VOIMASSA	
OH6HIO	VOIMASSA	
OH6HJ	VOIMASSA	
OH6HJE	VOIMASSA	
OH6HJG	VOIMASSA	
OH6HJM	VOIMASSA	
OH6HJP	VOIMASSA	
OH6HK	VOIMASSA	
OH6HKD	VOIMASSA	
OH6HKP	VOIMASSA	
OH6HKT	VOIMASSA	
OH6HLH	VOIMASSA	
OH6HM	VOIMASSA	
OH6HN	VOIMASSA	
OH6HNC	VOIMASSA	
OH6HO	VOIMASSA	
OH6HOL	VOIMASSA	
OH6HOW	VOIMASSA	
OH6HP	VOIMASSA	
OH6HPA	VOIMASSA	
OH6HPK	VOIMASSA	
OH6HPS	VOIMASSA	
OH6HQ	KARENSSI	
OH6HQI	VOIMASSA	
OH6HQK	VOIMASSA	
OH6HRA	VOIMASSA	
OH6HRJ	VOIMASSA	
OH6HRX	VOIMASSA	
OH6HSD	VOIMASSA	
OH6HSQ	VOIMASSA	
OH6HT	VOIMASSA	
OH6HTM	VOIMASSA	
OH6HUT	VOIMASSA	
OH6HW	VOIMASSA	
OH6HWW	VOIMASSA	
OH6HXA	VOIMASSA	
OH6HXF	VOIMASSA	
OH6HXU	VOIMASSA	
OH6HZ	VOIMASSA	
OH6HZH	VOIMASSA	
OH6ID	VOIMASSA	
OH6IG	VOIMASSA	
OH6IH	VOIMASSA	
OH6IJ	VOIMASSA	
OH6ILA	VOIMASSA	
OH6IO	VOIMASSA	
OH6IT	VOIMASSA	
OH6IU	KARENSSI	
OH6IY	VOIMASSA	
OH6IZ	VOIMASSA	
OH6J	VOIMASSA	
OH6JAB	VOIMASSA	
OH6JAK	VOIMASSA	
OH6JAT	VOIMASSA	
OH6JAV	VOIMASSA	
OH6JAZ	VOIMASSA	
OH6JB	VOIMASSA	
OH6JBC	VOIMASSA	
OH6JBX	VOIMASSA	
OH6JCC	VOIMASSA	
OH6JCD	VOIMASSA	
OH6JCT	VOIMASSA	
OH6JD	VOIMASSA	
OH6JDE	VOIMASSA	
OH6JDS	VOIMASSA	
OH6JE	VOIMASSA	
OH6JEB	VOIMASSA	
OH6JEN	VOIMASSA	
OH6JER	VOIMASSA	
OH6JES	VOIMASSA	
OH6JFR	VOIMASSA	
OH6JFS	VOIMASSA	
OH6JFY	VOIMASSA	
OH6JG	VOIMASSA	
OH6JGJ	VOIMASSA	
OH6JH	VOIMASSA	
OH6JHK	VOIMASSA	
OH6JIA	VOIMASSA	
OH6JIH	VOIMASSA	
OH6JJ	VOIMASSA	
OH6JJE	VOIMASSA	
OH6JJK	VOIMASSA	
OH6JJW	VOIMASSA	
OH6JJZ	VOIMASSA	
OH6JK	VOIMASSA	
OH6JKC	VOIMASSA	
OH6JKD	VOIMASSA	
OH6JKN	VOIMASSA	
OH6JKW	VOIMASSA	
OH6JL	VOIMASSA	
OH6JLA	VOIMASSA	
OH6JLB	VOIMASSA	
OH6JLZ	VOIMASSA	
OH6JM	VOIMASSA	
OH6JMN	VOIMASSA	
OH6JMT	VOIMASSA	
OH6JMU	VOIMASSA	
OH6JMW	VOIMASSA	
OH6JO	VOIMASSA	
OH6JOA	VOIMASSA	
OH6JOE	VOIMASSA	
OH6JOF	VOIMASSA	
OH6JON	VOIMASSA	
OH6JPC	VOIMASSA	
OH6JPE	VOIMASSA	
OH6JPN	VOIMASSA	
OH6JPU	VOIMASSA	
OH6JPZ	VOIMASSA	
OH6JQ	VOIMASSA	
OH6JQI	VOIMASSA	
OH6JQU	VOIMASSA	
OH6JRA	VOIMASSA	
OH6JRS	VOIMASSA	
OH6JS	VOIMASSA	
OH6JSH	VOIMASSA	
OH6JT	VOIMASSA	
OH6JTV	VOIMASSA	
OH6JTW	VOIMASSA	
OH6JUM	VOIMASSA	
OH6JV	VOIMASSA	
OH6JW	VOIMASSA	
OH6JWE	VOIMASSA	
OH6JVH	VOIMASSA	
OH6JVR	VOIMASSA	
OH6JX	VOIMASSA	
OH6JXF	VOIMASSA	
OH6JXJ	VOIMASSA	
OH6JXL	VOIMASSA	
OH6JYH	VOIMASSA	
OH6JYM	VOIMASSA	
OH6JYW	VOIMASSA	
OH6JZ	VOIMASSA	
OH6JZR	VOIMASSA	
OH6JZS	VOIMASSA	
OH6JZT	VOIMASSA	
OH6K	VOIMASSA	
OH6KA	VOIMASSA	
OH6KAC	VOIMASSA	
OH6KAF	VOIMASSA	
OH6KAI	VOIMASSA	
OH6KAM	VOIMASSA	
OH6KAZ	VOIMASSA	
OH6KB	VOIMASSA	
OH6KC	VOIMASSA	
OH6KCD	VOIMASSA	
OH6KD	VOIMASSA	
OH6KDA	VOIMASSA	
OH6KE	VOIMASSA	
OH6KEG	VOIMASSA	
OH6KFG	VOIMASSA	
OH6KFT	VOIMASSA	
OH6KFW	VOIMASSA	
OH6KFY	VOIMASSA	
OH6KG	VOIMASSA	
OH6KGV	VOIMASSA	
OH6KH	VOIMASSA	
OH6KHF	VOIMASSA	
OH6KHK	VOIMASSA	
OH6KHM	VOIMASSA	
OH6KHN	VOIMASSA	
OH6KHO	VOIMASSA	
OH6KHT	VOIMASSA	
OH6KI	VOIMASSA	
OH6KIC	VOIMASSA	
OH6KIT	VOIMASSA	
OH6KJ	KARENSSI	
OH6KJA	VOIMASSA	
OH6KJN	VOIMASSA	
OH6KK	VOIMASSA	
OH6KKM	VOIMASSA	
OH6KKN	VOIMASSA	
OH6KLI	VOIMASSA	
OH6KLR	VOIMASSA	
OH6KM	VOIMASSA	
OH6KMD	VOIMASSA	
OH6KMZ	VOIMASSA	
OH6KN	VOIMASSA	
OH6KNK	VOIMASSA	
OH6KNW	VOIMASSA	
OH6KO	KARENSSI	
OH6KOB	VOIMASSA	
OH6KOR	VOIMASSA	
OH6KP	VOIMASSA	
OH6KPA	VOIMASSA	
OH6KPB	VOIMASSA	
OH6KQC	VOIMASSA	
OH6KRD	VOIMASSA	
OH6KRE	VOIMASSA	
OH6KRW	VOIMASSA	
OH6KRZ	VOIMASSA	
OH6KS	VOIMASSA	
OH6KSW	VOIMASSA	
OH6KSX	VOIMASSA	
OH6KSZ	VOIMASSA	
OH6KT	VOIMASSA	
OH6KTD	VOIMASSA	
OH6KTL	VOIMASSA	
OH6KTM	VOIMASSA	
OH6KTR	VOIMASSA	
OH6KUC	VOIMASSA	
OH6KUL	VOIMASSA	
OH6KUM	VOIMASSA	
OH6KUU	VOIMASSA	
OH6KV	VOIMASSA	
OH6KW	VOIMASSA	
OH6KVF	VOIMASSA	
OH6KWL	VOIMASSA	
OH6KWN	VOIMASSA	
OH6KVP	VOIMASSA	
OH6KWT	VOIMASSA	
OH6KVU	VOIMASSA	
OH6KWU	VOIMASSA	
OH6KVW	VOIMASSA	
OH6KWV	VOIMASSA	
OH6KXC	VOIMASSA	
OH6KXF	VOIMASSA	
OH6KXL	VOIMASSA	
OH6KXM	VOIMASSA	
OH6KXQ	VOIMASSA	
OH6KY	VOIMASSA	
OH6KYD	VOIMASSA	
OH6KYF	VOIMASSA	
OH6KYI	VOIMASSA	
OH6KYK	VOIMASSA	
OH6KYU	VOIMASSA	
OH6KZJ	VOIMASSA	
OH6KZP	VOIMASSA	
OH6KZV	VOIMASSA	
OH6L	VOIMASSA	
OH6LA	VOIMASSA	
OH6LAO	VOIMASSA	
OH6LAT	VOIMASSA	
OH6LB	VOIMASSA	
OH6LBK	VOIMASSA	
OH6LBW	VOIMASSA	
OH6LC	VOIMASSA	
OH6LCN	VOIMASSA	
OH6LD	VOIMASSA	
OH6LDA	VOIMASSA	
OH6LDE	VOIMASSA	
OH6LDG	VOIMASSA	
OH6LDJ	VOIMASSA	
OH6LDK	VOIMASSA	
OH6LDL	VOIMASSA	
OH6LDN	VOIMASSA	
OH6LDP	VOIMASSA	
OH6LEB	VOIMASSA	
OH6LEE	VOIMASSA	
OH6LEH	VOIMASSA	
OH6LEI	VOIMASSA	
OH6LEZ	VOIMASSA	
OH6LF	VOIMASSA	
OH6LFA	VOIMASSA	
OH6LFG	VOIMASSA	
OH6LGK	VOIMASSA	
OH6LGP	VOIMASSA	
OH6LHB	VOIMASSA	
OH6LHR	VOIMASSA	
OH6LI	VOIMASSA	
OH6LJ	VOIMASSA	
OH6LJJ	KARENSSI	
OH6LJN	VOIMASSA	
OH6LK	VOIMASSA	
OH6LKA	VOIMASSA	
OH6LLS	VOIMASSA	
OH6LM	VOIMASSA	
OH6LME	VOIMASSA	
OH6LMH	VOIMASSA	
OH6LNI	VOIMASSA	
OH6LO	VOIMASSA	
OH6LOB	VOIMASSA	
OH6LOE	VOIMASSA	
OH6LOO	VOIMASSA	
OH6LOP	VOIMASSA	
OH6LOZ	VOIMASSA	
OH6LP	VOIMASSA	
OH6LPH	VOIMASSA	
OH6LPK	VOIMASSA	
OH6LPN	VOIMASSA	
OH6LQ	VOIMASSA	
OH6LQG	VOIMASSA	
OH6LQH	VOIMASSA	
OH6LR	VOIMASSA	
OH6LRL	VOIMASSA	
OH6LRR	VOIMASSA	
OH6LRU	VOIMASSA	
OH6LRX	VOIMASSA	
OH6LRZ	VOIMASSA	
OH6LS	VOIMASSA	
OH6LSA	VOIMASSA	
OH6LSC	VOIMASSA	
OH6LSL	VOIMASSA	
OH6LSP	VOIMASSA	
OH6LSR	VOIMASSA	
OH6LT	VOIMASSA	
OH6LTW	VOIMASSA	
OH6LU	VOIMASSA	
OH6LUC	VOIMASSA	
OH6LUE	VOIMASSA	
OH6LUJ	VOIMASSA	
OH6LUW	VOIMASSA	
OH6LV	VOIMASSA	
OH6LW	VOIMASSA	
OH6LVP	VOIMASSA	
OH6LXA	VOIMASSA	
OH6LXI	VOIMASSA	
OH6LXS	VOIMASSA	
OH6LXV	VOIMASSA	
OH6LYD	VOIMASSA	
OH6LYF	VOIMASSA	
OH6LYL	VOIMASSA	
OH6LYQ	VOIMASSA	
OH6LYV	VOIMASSA	
OH6LZD	VOIMASSA	
OH6LZG	VOIMASSA	
OH6LZO	VOIMASSA	
OH6LZX	VOIMASSA	
OH6LZZ	VOIMASSA	
OH6M	VOIMASSA	
OH6MA	VOIMASSA	
OH6MAA	VOIMASSA	
OH6MAH	VOIMASSA	
OH6MAP	VOIMASSA	
OH6MARI	VOIMASSA	
OH6MAZ	VOIMASSA	
OH6MBD	VOIMASSA	
OH6MBQ	VOIMASSA	
OH6MC	VOIMASSA	
OH6MCM	VOIMASSA	
OH6MCY	VOIMASSA	
OH6MCZ	VOIMASSA	
OH6MDB	VOIMASSA	
OH6MDO	VOIMASSA	
OH6MDP	VOIMASSA	
OH6MDX	VOIMASSA	
OH6ME	VOIMASSA	
OH6MEC	VOIMASSA	
OH6MEV	VOIMASSA	
OH6MF	VOIMASSA	
OH6MFD	VOIMASSA	
OH6MFY	VOIMASSA	
OH6MG	VOIMASSA	
OH6MGI	VOIMASSA	
OH6MH	VOIMASSA	
OH6MHD	VOIMASSA	
OH6MHP	VOIMASSA	
OH6MHS	VOIMASSA	
OH6MHZ	VOIMASSA	
OH6MIH	VOIMASSA	
OH6MIK	VOIMASSA	
OH6MIL	VOIMASSA	
OH6MIQ	VOIMASSA	
OH6MIR	VOIMASSA	
OH6MIW	VOIMASSA	
OH6MJ	VOIMASSA	
OH6MJH	VOIMASSA	
OH6MJM	VOIMASSA	
OH6MJV	VOIMASSA	
OH6MK	VOIMASSA	
OH6MKJ	VOIMASSA	
OH6MKL	VOIMASSA	
OH6MKO	VOIMASSA	
OH6MKS	VOIMASSA	
OH6MKY	VOIMASSA	
OH6ML	VOIMASSA	
OH6MLC	VOIMASSA	
OH6MLD	VOIMASSA	
OH6MLL	VOIMASSA	
OH6MLW	VOIMASSA	
OH6MMC	VOIMASSA	
OH6MML	VOIMASSA	
OH6MMP	VOIMASSA	
OH6MMQ	VOIMASSA	
OH6MN	VOIMASSA	
OH6MNS	VOIMASSA	
OH6MO	VOIMASSA	
OH6MOL	VOIMASSA	
OH6MOP	VOIMASSA	
OH6MOS	VOIMASSA	
OH6MP	VOIMASSA	
OH6MPC	VOIMASSA	
OH6MPG	VOIMASSA	
OH6MPJ	VOIMASSA	
OH6MPN	VOIMASSA	
OH6MQE	VOIMASSA	
OH6MQM	VOIMASSA	
OH6MQW	VOIMASSA	
OH6MR	VOIMASSA	
OH6MRA	VOIMASSA	
OH6MRD	VOIMASSA	
OH6MRG	VOIMASSA	
OH6MRV	VOIMASSA	
OH6MS	VOIMASSA	
OH6MSL	VOIMASSA	
OH6MSR	VOIMASSA	
OH6MSV	VOIMASSA	
OH6MSZ	VOIMASSA	
OH6MTB	VOIMASSA	
OH6MTG	VOIMASSA	
OH6MTI	VOIMASSA	
OH6MTP	VOIMASSA	
OH6MUE	VOIMASSA	
OH6MUG	VOIMASSA	
OH6MUL	VOIMASSA	
OH6MV	VOIMASSA	
OH6MW	VOIMASSA	
OH6MWC	VOIMASSA	
OH6MVG	VOIMASSA	
OH6MVI	VOIMASSA	
OH6MWQ	VOIMASSA	
OH6MWT	VOIMASSA	
OH6MWU	VOIMASSA	
OH6MXS	VOIMASSA	
OH6MY	VOIMASSA	
OH6MYU	VOIMASSA	
OH6MYZ	VOIMASSA	
OH6MZ	VOIMASSA	
OH6MZP	VOIMASSA	
OH6MZV	VOIMASSA	
OH6N	VOIMASSA	
OH6NA	VOIMASSA	
OH6NAZ	VOIMASSA	
OH6NC	VOIMASSA	
OH6NCE	VOIMASSA	
OH6ND	KARENSSI	
OH6NDT	VOIMASSA	
OH6NDZ	VOIMASSA	
OH6NE	VOIMASSA	
OH6NEA	VOIMASSA	
OH6NEK	VOIMASSA	
OH6NEQ	VOIMASSA	
OH6NES	VOIMASSA	
OH6NEV	VOIMASSA	
OH6NEX	VOIMASSA	
OH6NFV	VOIMASSA	
OH6NG	VOIMASSA	
OH6NGG	VOIMASSA	
OH6NGK	VOIMASSA	
OH6NGL	VOIMASSA	
OH6NGX	VOIMASSA	
OH6NHC	VOIMASSA	
OH6NHZ	VOIMASSA	
OH6NIE	VOIMASSA	
OH6NIH	VOIMASSA	
OH6NIO	VOIMASSA	
OH6NIR	VOIMASSA	
OH6NJ	VOIMASSA	
OH6NJM	VOIMASSA	
OH6NJX	VOIMASSA	
OH6NKC	VOIMASSA	
OH6NKI	VOIMASSA	
OH6NL	KARENSSI	
OH6NM	VOIMASSA	
OH6NMJ	VOIMASSA	
OH6NMY	VOIMASSA	
OH6NOJ	VOIMASSA	
OH6NOQ	VOIMASSA	
OH6NPC	VOIMASSA	
OH6NPJ	VOIMASSA	
OH6NPV	VOIMASSA	
OH6NPX	VOIMASSA	
OH6NPY	VOIMASSA	
OH6NQE	VOIMASSA	
OH6NQL	VOIMASSA	
OH6NR	VOIMASSA	
OH6NRL	VOIMASSA	
OH6NT	VOIMASSA	
OH6NTB	VOIMASSA	
OH6NTG	VOIMASSA	
OH6NTO	VOIMASSA	
OH6NTS	VOIMASSA	
OH6NUF	VOIMASSA	
OH6NUI	VOIMASSA	
OH6NUM	VOIMASSA	
OH6NUO	VOIMASSA	
OH6NUW	VOIMASSA	
OH6NV	VOIMASSA	
OH6NVC	VOIMASSA	
OH6NVE	VOIMASSA	
OH6NVG	VOIMASSA	
OH6NVN	VOIMASSA	
OH6NVO	VOIMASSA	
OH6NVQ	VOIMASSA	
OH6NXA	VOIMASSA	
OH6NXB	VOIMASSA	
OH6NYZ	VOIMASSA	
OH6NZ	VOIMASSA	
OH6NZD	VOIMASSA	
OH6NZE	VOIMASSA	
OH6O	VOIMASSA	
OH6OA	VOIMASSA	
OH6OF	KARENSSI	
OH6OH	KARENSSI	
OH6OI	VOIMASSA	
OH6OK	VOIMASSA	
OH6OKSA	VOIMASSA	
OH6OM	VOIMASSA	
OH6OO	VOIMASSA	
OH6OR	VOIMASSA	
OH6OS	VOIMASSA	
OH6OT	VOIMASSA	
OH6OW	VOIMASSA	
OH6OX	VOIMASSA	
OH6PA	VOIMASSA	
OH6PH	VOIMASSA	
OH6PK	VOIMASSA	
OH6PL	VOIMASSA	
OH6PM	VOIMASSA	
OH6PN	VOIMASSA	
OH6PO	VOIMASSA	
OH6POLA	VOIMASSA	
OH6PR	VOIMASSA	
OH6PRO	VOIMASSA	
OH6PS	VOIMASSA	
OH6PTK	VOIMASSA	
OH6PTO	VOIMASSA	
OH6PU	VOIMASSA	
OH6PV	VOIMASSA	
OH6PX	VOIMASSA	
OH6PZ	VOIMASSA	
OH6QB	VOIMASSA	
OH6QF	VOIMASSA	
OH6QG	VOIMASSA	
OH6QI	VOIMASSA	
OH6QK	VOIMASSA	
OH6QL	VOIMASSA	
OH6QR	VOIMASSA	
OH6QS	VOIMASSA	
OH6QU	VOIMASSA	
OH6R	VOIMASSA	
OH6RA	VOIMASSA	
OH6RAA	VOIMASSA	
OH6RAD	VOIMASSA	
OH6RAE	VOIMASSA	
OH6RAG	VOIMASSA	
OH6RAH	VOIMASSA	
OH6RAQ	VOIMASSA	
OH6RAR	VOIMASSA	
OH6RAW	VOIMASSA	
OH6RB	VOIMASSA	
OH6RC	VOIMASSA	
OH6RD	VOIMASSA	
OH6RDC	VOIMASSA	
OH6RDD	VOIMASSA	
OH6RDK	VOIMASSA	
OH6RDL	VOIMASSA	
OH6RDT	VOIMASSA	
OH6RE	VOIMASSA	
OH6RH	VOIMASSA	
OH6RJ	KARENSSI	
OH6RM	VOIMASSA	
OH6RO	VOIMASSA	
OH6RP	VOIMASSA	
OH6RQ	VOIMASSA	
OH6RS	KARENSSI	
OH6RUA	VOIMASSA	
OH6RUB	VOIMASSA	
OH6RUC	VOIMASSA	
OH6RUD	VOIMASSA	
OH6RUE	VOIMASSA	
OH6RUG	VOIMASSA	
OH6RUH	VOIMASSA	
OH6RUJ	VOIMASSA	
OH6RUP	VOIMASSA	
OH6RUQ	VOIMASSA	
OH6RUR	VOIMASSA	
OH6RUS	VOIMASSA	
OH6RUT	VOIMASSA	
OH6RUW	VOIMASSA	
OH6RW	VOIMASSA	
OH6RVC	VOIMASSA	
OH6RX	VOIMASSA	
OH6SARI	VOIMASSA	
OH6SC	VOIMASSA	
OH6SH	VOIMASSA	
OH6SHF	VOIMASSA	
OH6SI	KARENSSI	
OH6SJ	VOIMASSA	
OH6SKY	VOIMASSA	
OH6SM	VOIMASSA	
OH6SN	VOIMASSA	
OH6SO	VOIMASSA	
OH6SPR	VOIMASSA	
OH6SRAL	VOIMASSA	
OH6SS	VOIMASSA	
OH6STI	VOIMASSA	
OH6SUF	VOIMASSA	
OH6SWR	VOIMASSA	
OH6SX	VOIMASSA	
OH6SY	VOIMASSA	
OH6T	VOIMASSA	
OH6TA	VOIMASSA	
OH6TD	VOIMASSA	
OH6TES	VOIMASSA	
OH6TF	VOIMASSA	
OH6TG	VOIMASSA	
OH6TH	VOIMASSA	
OH6THK	VOIMASSA	
OH6TI	KARENSSI	
OH6TJ	VOIMASSA	
OH6TK	VOIMASSA	
OH6TN	VOIMASSA	
OH6TP	VOIMASSA	
OH6TQ	VOIMASSA	
OH6TR	VOIMASSA	
OH6TU	VOIMASSA	
OH6TX	VOIMASSA	
OH6TY	VOIMASSA	
OH6TZ	VOIMASSA	
OH6UAK	VOIMASSA	
OH6UAO	VOIMASSA	
OH6UAQ	VOIMASSA	
OH6UAS	VOIMASSA	
OH6UAV	VOIMASSA	
OH6UAW	VOIMASSA	
OH6UAX	VOIMASSA	
OH6UB	VOIMASSA	
OH6UBC	VOIMASSA	
OH6UBE	VOIMASSA	
OH6UC	VOIMASSA	
OH6UCA	VOIMASSA	
OH6UCJ	VOIMASSA	
OH6UCT	VOIMASSA	
OH6UCV	VOIMASSA	
OH6UCW	VOIMASSA	
OH6UDL	VOIMASSA	
OH6UDO	VOIMASSA	
OH6UDP	VOIMASSA	
OH6UDU	VOIMASSA	
OH6UE	VOIMASSA	
OH6UHF	VOIMASSA	
OH6UI	VOIMASSA	
OH6UK	VOIMASSA	
OH6UM	VOIMASSA	
OH6UNJ	VOIMASSA	
OH6UO	VOIMASSA	
OH6UTI	VOIMASSA	
OH6UU	VOIMASSA	
OH6UW	VOIMASSA	
OH6UX	VOIMASSA	
OH6V	VOIMASSA	
OH6W	VOIMASSA	
OH6VA	VOIMASSA	
OH6WA	VOIMASSA	
OH6WB	VOIMASSA	
OH6WD	VOIMASSA	
OH6VDA	VOIMASSA	
OH6WE	VOIMASSA	
OH6WG	VOIMASSA	
OH6WH	VOIMASSA	
OH6VI	VOIMASSA	
OH6WI	VOIMASSA	
OH6VJ	VOIMASSA	
OH6WL	VOIMASSA	
OH6VN	VOIMASSA	
OH6VP	VOIMASSA	
OH6WP	VOIMASSA	
OH6WQ	VOIMASSA	
OH6VR	VOIMASSA	
OH6WR	VOIMASSA	
OH6WU	VOIMASSA	
OH6VV	VOIMASSA	
OH6VW	VOIMASSA	
OH6WV	VOIMASSA	
OH6WW	VOIMASSA	
OH6WX	VOIMASSA	
OH6VY	VOIMASSA	
OH6X	VOIMASSA	
OH6XA	VOIMASSA	
OH6XB	VOIMASSA	
OH6XC	VOIMASSA	
OH6XE	VOIMASSA	
OH6XF	VOIMASSA	
OH6XG	VOIMASSA	
OH6XI	VOIMASSA	
OH6XJ	VOIMASSA	
OH6XN	VOIMASSA	
OH6XO	VOIMASSA	
OH6XU	VOIMASSA	
OH6XV	VOIMASSA	
OH6XX	VOIMASSA	
OH6XY	VOIMASSA	
OH6Y	VOIMASSA	
OH6YAR	VOIMASSA	
OH6YC	VOIMASSA	
OH6YD	VOIMASSA	
OH6YH	VOIMASSA	
OH6YI	VOIMASSA	
OH6YK	VOIMASSA	
OH6YL	VOIMASSA	
OH6YM	VOIMASSA	
OH6YT	VOIMASSA	
OH6YW	VOIMASSA	
OH6YX	VOIMASSA	
OH6YZ	VOIMASSA	
OH6Z	VOIMASSA	
OH6ZF	VOIMASSA	
OH6ZH	VOIMASSA	
OH6ZI	VOIMASSA	
OH6ZJ	VOIMASSA	
OH6ZK	VOIMASSA	
OH6ZR	VOIMASSA	
OH6ZS	VOIMASSA	
OH6ZW	VOIMASSA	
OH6ZX	VOIMASSA	
OH6ZZ	VOIMASSA	
OH70BH	VOIMASSA	
OH73ELK	VOIMASSA	
OH7A	VOIMASSA	
OH7AA	VOIMASSA	
OH7AAC	VOIMASSA	
OH7AAX	VOIMASSA	
OH7AB	VOIMASSA	
OH7ABC	VOIMASSA	
OH7ABE	VOIMASSA	
OH7AI	VOIMASSA	
OH7AWS	VOIMASSA	
OH7AZC	VOIMASSA	
OH7AZL	VOIMASSA	
OH7AZO	VOIMASSA	
OH7AZT	VOIMASSA	
OH7AZX	VOIMASSA	
OH7AZY	VOIMASSA	
OH7BA	VOIMASSA	
OH7BB	VOIMASSA	
OH7BBF	VOIMASSA	
OH7BC	VOIMASSA	
OH7BD	VOIMASSA	
OH7BDI	VOIMASSA	
OH7BF	VOIMASSA	
OH7BFB	VOIMASSA	
OH7BFJ	VOIMASSA	
OH7BFL	VOIMASSA	
OH7BFY	VOIMASSA	
OH7BGF	VOIMASSA	
OH7BGP	VOIMASSA	
OH7BGY	VOIMASSA	
OH7BIC	VOIMASSA	
OH7BIE	VOIMASSA	
OH7BJY	VOIMASSA	
OH7BL	VOIMASSA	
OH7BN	VOIMASSA	
OH7BNK	VOIMASSA	
OH7BO	VOIMASSA	
OH7BRC	VOIMASSA	
OH7BW	VOIMASSA	
OH7BX	VOIMASSA	
OH7BXD	VOIMASSA	
OH7BXH	VOIMASSA	
OH7BY	VOIMASSA	
OH7BZB	VOIMASSA	
OH7BZV	VOIMASSA	
OH7C	VOIMASSA	
OH7CB	KARENSSI	
OH7CBC	VOIMASSA	
OH7CBK	VOIMASSA	
OH7CEJ	VOIMASSA	
OH7CEZ	VOIMASSA	
OH7CFG	VOIMASSA	
OH7CFV	VOIMASSA	
OH7CGO	VOIMASSA	
OH7CQ	VOIMASSA	
OH7CW	VOIMASSA	
OH7CX	VOIMASSA	
OH7DB	VOIMASSA	
OH7DC	VOIMASSA	
OH7DF	VOIMASSA	
OH7DG	VOIMASSA	
OH7DI	VOIMASSA	
OH7DK	VOIMASSA	
OH7DKW	VOIMASSA	
OH7DMR	VOIMASSA	
OH7DW	VOIMASSA	
OH7DX	VOIMASSA	
OH7EA	VOIMASSA	
OH7EAG	VOIMASSA	
OH7EAH	VOIMASSA	
OH7EAL	VOIMASSA	
OH7EBA	VOIMASSA	
OH7EBY	VOIMASSA	
OH7ECA	VOIMASSA	
OH7EDN	VOIMASSA	
OH7EEH	VOIMASSA	
OH7EEI	VOIMASSA	
OH7EEJ	VOIMASSA	
OH7EEK	VOIMASSA	
OH7EEP	VOIMASSA	
OH7EEV	VOIMASSA	
OH7EEW	VOIMASSA	
OH7EG	VOIMASSA	
OH7EH	VOIMASSA	
OH7EJ	KARENSSI	
OH7EKE	VOIMASSA	
OH7EKL	VOIMASSA	
OH7EML	VOIMASSA	
OH7EMN	VOIMASSA	
OH7ENS	VOIMASSA	
OH7EOI	VOIMASSA	
OH7EOO	VOIMASSA	
OH7EOV	VOIMASSA	
OH7EOW	VOIMASSA	
OH7EOX	VOIMASSA	
OH7EOY	VOIMASSA	
OH7EOZ	VOIMASSA	
OH7EP	VOIMASSA	
OH7ER	VOIMASSA	
OH7ESW	VOIMASSA	
OH7ET	VOIMASSA	
OH7EU	VOIMASSA	
OH7EV	VOIMASSA	
OH7EVL	VOIMASSA	
OH7EXT	VOIMASSA	
OH7EY	VOIMASSA	
OH7FAE	VOIMASSA	
OH7FDN	VOIMASSA	
OH7FDV	VOIMASSA	
OH7FDY	VOIMASSA	
OH7FES	VOIMASSA	
OH7FF	VOIMASSA	
OH7FFX	VOIMASSA	
OH7FHU	VOIMASSA	
OH7FIN	VOIMASSA	
OH7FKG	VOIMASSA	
OH7FKV	VOIMASSA	
OH7FLP	VOIMASSA	
OH7FLR	VOIMASSA	
OH7FMS	VOIMASSA	
OH7FMT	VOIMASSA	
OH7FMY	VOIMASSA	
OH7FNB	VOIMASSA	
OH7FNC	VOIMASSA	
OH7FND	VOIMASSA	
OH7FOE	VOIMASSA	
OH7FPO	VOIMASSA	
OH7FQH	VOIMASSA	
OH7FQP	VOIMASSA	
OH7FQQ	VOIMASSA	
OH7FRY	VOIMASSA	
OH7FTM	VOIMASSA	
OH7FUG	VOIMASSA	
OH7FVG	VOIMASSA	
OH7FWQ	VOIMASSA	
OH7FVZ	VOIMASSA	
OH7FXK	VOIMASSA	
OH7FXU	VOIMASSA	
OH7FXX	VOIMASSA	
OH7FZB	VOIMASSA	
OH7FZC	VOIMASSA	
OH7FZX	VOIMASSA	
OH7FZZ	VOIMASSA	
OH7GCT	VOIMASSA	
OH7GGX	VOIMASSA	
OH7GIG	VOIMASSA	
OH7GIQ	VOIMASSA	
OH7GKC	VOIMASSA	
OH7GKD	VOIMASSA	
OH7GNG	VOIMASSA	
OH7GOF	VOIMASSA	
OH7GTJ	VOIMASSA	
OH7GWA	VOIMASSA	
OH7GVL	VOIMASSA	
OH7GWM	VOIMASSA	
OH7GYB	VOIMASSA	
OH7GYD	VOIMASSA	
OH7GYK	VOIMASSA	
OH7GYN	VOIMASSA	
OH7HAP	VOIMASSA	
OH7HD	VOIMASSA	
OH7HEP	VOIMASSA	
OH7HET	VOIMASSA	
OH7HFR	VOIMASSA	
OH7HFU	VOIMASSA	
OH7HHI	VOIMASSA	
OH7HJ	VOIMASSA	
OH7HJX	VOIMASSA	
OH7HKS	VOIMASSA	
OH7HKV	VOIMASSA	
OH7HL	VOIMASSA	
OH7HM	VOIMASSA	
OH7HMC	VOIMASSA	
OH7HMN	VOIMASSA	
OH7HMS	VOIMASSA	
OH7HMT	VOIMASSA	
OH7HOU	VOIMASSA	
OH7HRH	VOIMASSA	
OH7HSM	VOIMASSA	
OH7HXH	VOIMASSA	
OH7IM	VOIMASSA	
OH7J	VOIMASSA	
OH7JA	VOIMASSA	
OH7JEO	VOIMASSA	
OH7JEV	VOIMASSA	
OH7JFE	VOIMASSA	
OH7JG	VOIMASSA	
OH7JGT	VOIMASSA	
OH7JH	VOIMASSA	
OH7JHA	VOIMASSA	
OH7JHF	VOIMASSA	
OH7JHH	VOIMASSA	
OH7JI	VOIMASSA	
OH7JIQ	VOIMASSA	
OH7JJT	VOIMASSA	
OH7JK	VOIMASSA	
OH7JKL	VOIMASSA	
OH7JL	VOIMASSA	
OH7JLU	VOIMASSA	
OH7JLW	VOIMASSA	
OH7JLY	VOIMASSA	
OH7JMA	VOIMASSA	
OH7JMK	VOIMASSA	
OH7JP	VOIMASSA	
OH7JQA	VOIMASSA	
OH7JQR	VOIMASSA	
OH7JR	VOIMASSA	
OH7JRI	VOIMASSA	
OH7JRZ	VOIMASSA	
OH7JS	VOIMASSA	
OH7JSM	VOIMASSA	
OH7JT	VOIMASSA	
OH7JU	VOIMASSA	
OH7JUC	VOIMASSA	
OH7JVD	VOIMASSA	
OH7JWX	VOIMASSA	
OH7JXM	VOIMASSA	
OH7JYS	VOIMASSA	
OH7JZM	VOIMASSA	
OH7K	VOIMASSA	
OH7KA	VOIMASSA	
OH7KAA	VOIMASSA	
OH7KB	VOIMASSA	
OH7KBF	VOIMASSA	
OH7KC	VOIMASSA	
OH7KCX	VOIMASSA	
OH7KD	VOIMASSA	
OH7KEE	VOIMASSA	
OH7KF	VOIMASSA	
OH7KFA	VOIMASSA	
OH7KGW	VOIMASSA	
OH7KHB	VOIMASSA	
OH7KHW	VOIMASSA	
OH7KID	VOIMASSA	
OH7KIM	VOIMASSA	
OH7KIR	VOIMASSA	
OH7KM	VOIMASSA	
OH7KNM	VOIMASSA	
OH7KNN	VOIMASSA	
OH7KNV	VOIMASSA	
OH7KOLI	VOIMASSA	
OH7KP	VOIMASSA	
OH7KPM	VOIMASSA	
OH7KQV	VOIMASSA	
OH7KR	VOIMASSA	
OH7KT	VOIMASSA	
OH7KUD	VOIMASSA	
OH7KW	VOIMASSA	
OH7KVC	VOIMASSA	
OH7KWX	VOIMASSA	
OH7KX	VOIMASSA	
OH7KXB	VOIMASSA	
OH7L	VOIMASSA	
OH7LAJ	VOIMASSA	
OH7LDZ	VOIMASSA	
OH7LFJ	VOIMASSA	
OH7LFM	VOIMASSA	
OH7LIT	VOIMASSA	
OH7LIX	VOIMASSA	
OH7LML	VOIMASSA	
OH7LMQ	VOIMASSA	
OH7LMR	VOIMASSA	
OH7LNL	VOIMASSA	
OH7LNP	VOIMASSA	
OH7LOA	VOIMASSA	
OH7LOG	VOIMASSA	
OH7LOX	VOIMASSA	
OH7LOY	VOIMASSA	
OH7LPS	VOIMASSA	
OH7LPV	VOIMASSA	
OH7LRJ	VOIMASSA	
OH7LUA	VOIMASSA	
OH7LVF	VOIMASSA	
OH7LWI	VOIMASSA	
OH7LWU	VOIMASSA	
OH7LXL	VOIMASSA	
OH7LZB	VOIMASSA	
OH7M	VOIMASSA	
OH7MA	VOIMASSA	
OH7MBZ	VOIMASSA	
OH7MDS	VOIMASSA	
OH7ME	VOIMASSA	
OH7MEW	VOIMASSA	
OH7MEY	VOIMASSA	
OH7MFO	VOIMASSA	
OH7MGC	VOIMASSA	
OH7MHB	VOIMASSA	
OH7MHF	VOIMASSA	
OH7MHL	VOIMASSA	
OH7MIRO	VOIMASSA	
OH7MJU	VOIMASSA	
OH7MK	VOIMASSA	
OH7ML	VOIMASSA	
OH7MLE	VOIMASSA	
OH7MM	VOIMASSA	
OH7MMT	VOIMASSA	
OH7MMY	VOIMASSA	
OH7MP	VOIMASSA	
OH7MRU	VOIMASSA	
OH7MS	VOIMASSA	
OH7MSH	VOIMASSA	
OH7MTV	VOIMASSA	
OH7MUO	VOIMASSA	
OH7MV	VOIMASSA	
OH7MWM	VOIMASSA	
OH7MWO	VOIMASSA	
OH7MVS	VOIMASSA	
OH7MXF	VOIMASSA	
OH7MYK	VOIMASSA	
OH7MZU	VOIMASSA	
OH7N	VOIMASSA	
OH7ND	VOIMASSA	
OH7NDX	VOIMASSA	
OH7NE	VOIMASSA	
OH7NFA	VOIMASSA	
OH7NGC	VOIMASSA	
OH7NGM	VOIMASSA	
OH7NJ	VOIMASSA	
OH7NJJ	VOIMASSA	
OH7NJL	VOIMASSA	
OH7NK	VOIMASSA	
OH7NO	VOIMASSA	
OH7NOW	VOIMASSA	
OH7NQI	VOIMASSA	
OH7NRW	VOIMASSA	
OH7NSI	VOIMASSA	
OH7NTZ	VOIMASSA	
OH7NU	VOIMASSA	
OH7NUV	VOIMASSA	
OH7NW	VOIMASSA	
OH7NYF	VOIMASSA	
OH7NYO	VOIMASSA	
OH7ON	VOIMASSA	
OH7OP	KARENSSI	
OH7OX	KARENSSI	
OH7P	VOIMASSA	
OH7PD	KARENSSI	
OH7PE	VOIMASSA	
OH7PF	VOIMASSA	
OH7PI	VOIMASSA	
OH7PN	VOIMASSA	
OH7PO	VOIMASSA	
OH7PS	VOIMASSA	
OH7QA	VOIMASSA	
OH7QH	VOIMASSA	
OH7QK	VOIMASSA	
OH7QR	VOIMASSA	
OH7QT	VOIMASSA	
OH7QV	VOIMASSA	
OH7R	VOIMASSA	
OH7RAA	VOIMASSA	
OH7RAB	VOIMASSA	
OH7RAC	VOIMASSA	
OH7RAD	VOIMASSA	
OH7RAE	VOIMASSA	
OH7RAI	VOIMASSA	
OH7RAJ	VOIMASSA	
OH7RAL	VOIMASSA	
OH7RDA	VOIMASSA	
OH7RDB	VOIMASSA	
OH7RDC	VOIMASSA	
OH7RDD	VOIMASSA	
OH7RDJ	VOIMASSA	
OH7RDK	VOIMASSA	
OH7RDL	VOIMASSA	
OH7RDM	VOIMASSA	
OH7RDO	VOIMASSA	
OH7RDR	VOIMASSA	
OH7RDT	VOIMASSA	
OH7RE	VOIMASSA	
OH7RF	VOIMASSA	
OH7RH	VOIMASSA	
OH7RJ	VOIMASSA	
OH7RK	VOIMASSA	
OH7RM	VOIMASSA	
OH7RN	VOIMASSA	
OH7RR	VOIMASSA	
OH7RUA	VOIMASSA	
OH7RUB	VOIMASSA	
OH7RUI	VOIMASSA	
OH7RX	VOIMASSA	
OH7RY	VOIMASSA	
OH7S	VOIMASSA	
OH7SC	VOIMASSA	
OH7SG	VOIMASSA	
OH7SI	VOIMASSA	
OH7SJ	KARENSSI	
OH7SK	VOIMASSA	
OH7SL	VOIMASSA	
OH7SM	VOIMASSA	
OH7SP	VOIMASSA	
OH7SQ	VOIMASSA	
OH7SS	VOIMASSA	
OH7SUF	VOIMASSA	
OH7SV	VOIMASSA	
OH7SX	VOIMASSA	
OH7T	VOIMASSA	
OH7TB	VOIMASSA	
OH7TE	KARENSSI	
OH7TEME	VOIMASSA	
OH7TI	VOIMASSA	
OH7TJ	VOIMASSA	
OH7TL	VOIMASSA	
OH7TM	VOIMASSA	
OH7TN	VOIMASSA	
OH7TO	VOIMASSA	
OH7TOPI	VOIMASSA	
OH7TP	VOIMASSA	
OH7TQ	VOIMASSA	
OH7TR	VOIMASSA	
OH7TT	VOIMASSA	
OH7TU	VOIMASSA	
OH7TV	VOIMASSA	
OH7TW	VOIMASSA	
OH7TX	VOIMASSA	
OH7TY	VOIMASSA	
OH7UAB	VOIMASSA	
OH7UCC	VOIMASSA	
OH7UDH	VOIMASSA	
OH7UDJ	VOIMASSA	
OH7UE	VOIMASSA	
OH7UG	VOIMASSA	
OH7UHF	VOIMASSA	
OH7UK	VOIMASSA	
OH7UM	VOIMASSA	
OH7UV	VOIMASSA	
OH7W	VOIMASSA	
OH7WA	VOIMASSA	
OH7WB	VOIMASSA	
OH7WD	VOIMASSA	
OH7VHF	VOIMASSA	
OH7VI	VOIMASSA	
OH7VJ	VOIMASSA	
OH7WJ	VOIMASSA	
OH7VL	VOIMASSA	
OH7WL	VOIMASSA	
OH7VM	VOIMASSA	
OH7WN	VOIMASSA	
OH7WP	VOIMASSA	
OH7WQ	VOIMASSA	
OH7VS	VOIMASSA	
OH7VV	VOIMASSA	
OH7WV	VOIMASSA	
OH7WW	VOIMASSA	
OH7VX	VOIMASSA	
OH7WX	VOIMASSA	
OH7WY	VOIMASSA	
OH7VZ	VOIMASSA	
OH7X	VOIMASSA	
OH7XC	VOIMASSA	
OH7XE	VOIMASSA	
OH7XI	VOIMASSA	
OH7XM	VOIMASSA	
OH7XR	VOIMASSA	
OH7XS	VOIMASSA	
OH7XU	VOIMASSA	
OH7XX	VOIMASSA	
OH7XY	VOIMASSA	
OH7YL	VOIMASSA	
OH7YN	KARENSSI	
OH7Z	VOIMASSA	
OH80X	VOIMASSA	
OH85B	VOIMASSA	
OH88T	VOIMASSA	
OH8A	VOIMASSA	
OH8AA	VOIMASSA	
OH8AAU	VOIMASSA	
OH8ABV	VOIMASSA	
OH8ACB	VOIMASSA	
OH8AK	VOIMASSA	
OH8AV	VOIMASSA	
OH8AXM	VOIMASSA	
OH8AXP	VOIMASSA	
OH8AXV	VOIMASSA	
OH8AZC	VOIMASSA	
OH8AZJ	VOIMASSA	
OH8AZU	VOIMASSA	
OH8AZX	VOIMASSA	
OH8BBO	VOIMASSA	
OH8BDO	VOIMASSA	
OH8BEZ	VOIMASSA	
OH8BGL	VOIMASSA	
OH8BHM	VOIMASSA	
OH8BHW	VOIMASSA	
OH8BIM	VOIMASSA	
OH8BIQ	VOIMASSA	
OH8BJS	VOIMASSA	
OH8BKG	VOIMASSA	
OH8BLH	VOIMASSA	
OH8BLJ	VOIMASSA	
OH8BLW	VOIMASSA	
OH8BOA	VOIMASSA	
OH8BPD	VOIMASSA	
OH8BSB	VOIMASSA	
OH8BSJ	VOIMASSA	
OH8BXZ	VOIMASSA	
OH8BYV	VOIMASSA	
OH8BZH	VOIMASSA	
OH8CA	VOIMASSA	
OH8CAI	VOIMASSA	
OH8CCO	VOIMASSA	
OH8CCS	VOIMASSA	
OH8CEH	VOIMASSA	
OH8CEL	VOIMASSA	
OH8CFH	VOIMASSA	
OH8CW	VOIMASSA	
OH8D	VOIMASSA	
OH8DD	VOIMASSA	
OH8DG	VOIMASSA	
OH8DJ	VOIMASSA	
OH8DR	VOIMASSA	
OH8DX	VOIMASSA	
OH8EA	VOIMASSA	
OH8EAA	VOIMASSA	
OH8EBG	VOIMASSA	
OH8EBH	VOIMASSA	
OH8EC	VOIMASSA	
OH8ED	VOIMASSA	
OH8EDR	VOIMASSA	
OH8EDS	VOIMASSA	
OH8EET	VOIMASSA	
OH8EFI	VOIMASSA	
OH8EFJ	VOIMASSA	
OH8EFK	VOIMASSA	
OH8EFL	VOIMASSA	
OH8EFM	VOIMASSA	
OH8EFN	VOIMASSA	
OH8EHS	VOIMASSA	
OH8EHU	VOIMASSA	
OH8EHV	VOIMASSA	
OH8EHY	VOIMASSA	
OH8EJS	VOIMASSA	
OH8EJT	VOIMASSA	
OH8EJV	VOIMASSA	
OH8EJW	VOIMASSA	
OH8EJX	VOIMASSA	
OH8EK	VOIMASSA	
OH8EKC	VOIMASSA	
OH8EKD	VOIMASSA	
OH8EKV	VOIMASSA	
OH8ELE	VOIMASSA	
OH8ELL	VOIMASSA	
OH8ENQ	VOIMASSA	
OH8ENT	VOIMASSA	
OH8EOC	VOIMASSA	
OH8EOM	VOIMASSA	
OH8EOS	VOIMASSA	
OH8EOT	VOIMASSA	
OH8EP	VOIMASSA	
OH8EPJ	VOIMASSA	
OH8ERR	VOIMASSA	
OH8ESV	VOIMASSA	
OH8ET	VOIMASSA	
OH8ETB	VOIMASSA	
OH8ETG	VOIMASSA	
OH8EUN	VOIMASSA	
OH8EUO	VOIMASSA	
OH8EVG	VOIMASSA	
OH8EXO	VOIMASSA	
OH8EXP	VOIMASSA	
OH8EZA	VOIMASSA	
OH8EZK	VOIMASSA	
OH8F	VOIMASSA	
OH8FAF	VOIMASSA	
OH8FAL	VOIMASSA	
OH8FBD	VOIMASSA	
OH8FCK	VOIMASSA	
OH8FCP	VOIMASSA	
OH8FEF	VOIMASSA	
OH8FGI	VOIMASSA	
OH8FGS	VOIMASSA	
OH8FGT	VOIMASSA	
OH8FHB	VOIMASSA	
OH8FHC	VOIMASSA	
OH8FHD	VOIMASSA	
OH8FIU	VOIMASSA	
OH8FKK	VOIMASSA	
OH8FKS	VOIMASSA	
OH8FKU	VOIMASSA	
OH8FOV	VOIMASSA	
OH8FOW	VOIMASSA	
OH8FPT	VOIMASSA	
OH8FPV	VOIMASSA	
OH8FQS	VOIMASSA	
OH8FSN	VOIMASSA	
OH8FTF	VOIMASSA	
OH8FWY	VOIMASSA	
OH8FWZ	VOIMASSA	
OH8FXA	VOIMASSA	
OH8FZL	VOIMASSA	
OH8FZW	VOIMASSA	
OH8G	VOIMASSA	
OH8GAA	VOIMASSA	
OH8GAD	VOIMASSA	
OH8GBN	VOIMASSA	
OH8GBO	VOIMASSA	
OH8GBP	VOIMASSA	
OH8GBT	VOIMASSA	
OH8GBX	VOIMASSA	
OH8GCW	VOIMASSA	
OH8GCX	VOIMASSA	
OH8GDC	VOIMASSA	
OH8GDK	VOIMASSA	
OH8GDR	VOIMASSA	
OH8GDU	VOIMASSA	
OH8GDV	VOIMASSA	
OH8GDW	VOIMASSA	
OH8GDY	VOIMASSA	
OH8GEA	VOIMASSA	
OH8GEB	VOIMASSA	
OH8GEG	VOIMASSA	
OH8GEJ	VOIMASSA	
OH8GET	VOIMASSA	
OH8GJF	VOIMASSA	
OH8GKP	VOIMASSA	
OH8GLL	VOIMASSA	
OH8GLU	VOIMASSA	
OH8GLV	VOIMASSA	
OH8GM	KARENSSI	
OH8GMC	VOIMASSA	
OH8GMW	VOIMASSA	
OH8GNN	VOIMASSA	
OH8GNR	VOIMASSA	
OH8GNS	VOIMASSA	
OH8GNV	VOIMASSA	
OH8GNZ	VOIMASSA	
OH8GOG	VOIMASSA	
OH8GOP	VOIMASSA	
OH8GOT	VOIMASSA	
OH8GOU	VOIMASSA	
OH8GRF	VOIMASSA	
OH8GRQ	VOIMASSA	
OH8GT	VOIMASSA	
OH8GTE	VOIMASSA	
OH8GUE	VOIMASSA	
OH8GUK	VOIMASSA	
OH8GUY	VOIMASSA	
OH8GVQ	VOIMASSA	
OH8GWW	VOIMASSA	
OH8GWX	VOIMASSA	
OH8GYE	VOIMASSA	
OH8GYR	VOIMASSA	
OH8GZQ	VOIMASSA	
OH8GZU	VOIMASSA	
OH8GZY	VOIMASSA	
OH8GZZ	VOIMASSA	
OH8HA	VOIMASSA	
OH8HAK	VOIMASSA	
OH8HAR	VOIMASSA	
OH8HBB	VOIMASSA	
OH8HBF	VOIMASSA	
OH8HBG	VOIMASSA	
OH8HDL	VOIMASSA	
OH8HDS	VOIMASSA	
OH8HEA	VOIMASSA	
OH8HEO	VOIMASSA	
OH8HGV	VOIMASSA	
OH8HHP	VOIMASSA	
OH8HIG	VOIMASSA	
OH8HIS	VOIMASSA	
OH8HJJ	VOIMASSA	
OH8HMX	VOIMASSA	
OH8HNQ	VOIMASSA	
OH8HPI	VOIMASSA	
OH8HPT	VOIMASSA	
OH8HQL	VOIMASSA	
OH8HRY	VOIMASSA	
OH8HSA	VOIMASSA	
OH8HTG	VOIMASSA	
OH8HTH	VOIMASSA	
OH8HTY	VOIMASSA	
OH8HUB	VOIMASSA	
OH8HUC	VOIMASSA	
OH8HWI	VOIMASSA	
OH8HWL	VOIMASSA	
OH8HWM	VOIMASSA	
OH8HVW	VOIMASSA	
OH8HYA	VOIMASSA	
OH8HYW	VOIMASSA	
OH8HZS	VOIMASSA	
OH8HZX	VOIMASSA	
OH8J	VOIMASSA	
OH8JBG	VOIMASSA	
OH8JBN	VOIMASSA	
OH8JBO	VOIMASSA	
OH8JBS	VOIMASSA	
OH8JEJ	VOIMASSA	
OH8JEP	VOIMASSA	
OH8JGD	VOIMASSA	
OH8JGG	VOIMASSA	
OH8JGL	VOIMASSA	
OH8JGQ	VOIMASSA	
OH8JGZ	VOIMASSA	
OH8JHD	VOIMASSA	
OH8JIX	VOIMASSA	
OH8JJ	VOIMASSA	
OH8JK	VOIMASSA	
OH8JKH	VOIMASSA	
OH8JKQ	VOIMASSA	
OH8JM	VOIMASSA	
OH8JMZ	VOIMASSA	
OH8JO	VOIMASSA	
OH8JOV	VOIMASSA	
OH8JP	VOIMASSA	
OH8JQJ	VOIMASSA	
OH8JQM	VOIMASSA	
OH8JRL	VOIMASSA	
OH8JSA	VOIMASSA	
OH8JSN	VOIMASSA	
OH8JSZ	VOIMASSA	
OH8JT	VOIMASSA	
OH8JUB	VOIMASSA	
OH8JUK	VOIMASSA	
OH8JV	VOIMASSA	
OH8JXB	VOIMASSA	
OH8JXR	VOIMASSA	
OH8JYO	VOIMASSA	
OH8JYV	VOIMASSA	
OH8K	KARENSSI	
OH8KA	VOIMASSA	
OH8KAW	VOIMASSA	
OH8KBY	VOIMASSA	
OH8KBZ	VOIMASSA	
OH8KC	VOIMASSA	
OH8KCK	VOIMASSA	
OH8KEB	VOIMASSA	
OH8KER	VOIMASSA	
OH8KF	VOIMASSA	
OH8KFN	VOIMASSA	
OH8KFS	VOIMASSA	
OH8KGA	VOIMASSA	
OH8KH	VOIMASSA	
OH8KHD	VOIMASSA	
OH8KHE	VOIMASSA	
OH8KIG	VOIMASSA	
OH8KJP	VOIMASSA	
OH8KLD	VOIMASSA	
OH8KLH	VOIMASSA	
OH8KN	VOIMASSA	
OH8KSN	VOIMASSA	
OH8KTN	VOIMASSA	
OH8KTX	VOIMASSA	
OH8KW	VOIMASSA	
OH8KVA	VOIMASSA	
OH8KWB	VOIMASSA	
OH8KVX	VOIMASSA	
OH8KVY	VOIMASSA	
OH8KXK	VOIMASSA	
OH8KXP	VOIMASSA	
OH8L	VOIMASSA	
OH8LA	VOIMASSA	
OH8LAE	VOIMASSA	
OH8LAX	VOIMASSA	
OH8LB	VOIMASSA	
OH8LCC	VOIMASSA	
OH8LDH	VOIMASSA	
OH8LDQ	VOIMASSA	
OH8LE	VOIMASSA	
OH8LFY	VOIMASSA	
OH8LGC	VOIMASSA	
OH8LH	VOIMASSA	
OH8LIW	VOIMASSA	
OH8LK	VOIMASSA	
OH8LKZ	VOIMASSA	
OH8LLB	VOIMASSA	
OH8LOO	VOIMASSA	
OH8LP	VOIMASSA	
OH8LQ	VOIMASSA	
OH8LQC	VOIMASSA	
OH8LQD	VOIMASSA	
OH8LRB	VOIMASSA	
OH8LRN	VOIMASSA	
OH8LSI	VOIMASSA	
OH8LTF	VOIMASSA	
OH8LXT	VOIMASSA	
OH8LYC	VOIMASSA	
OH8M	VOIMASSA	
OH8MAKE	VOIMASSA	
OH8MBN	VOIMASSA	
OH8MBP	VOIMASSA	
OH8MBU	VOIMASSA	
OH8MCD	VOIMASSA	
OH8MCE	VOIMASSA	
OH8MCT	VOIMASSA	
OH8MD	VOIMASSA	
OH8MDD	VOIMASSA	
OH8MDI	VOIMASSA	
OH8MDL	VOIMASSA	
OH8MDQ	VOIMASSA	
OH8MEJ	VOIMASSA	
OH8MEN	VOIMASSA	
OH8MF	VOIMASSA	
OH8MFF	VOIMASSA	
OH8MFH	VOIMASSA	
OH8MFI	VOIMASSA	
OH8MGK	VOIMASSA	
OH8MGM	VOIMASSA	
OH8MI	VOIMASSA	
OH8MIB	VOIMASSA	
OH8MII	VOIMASSA	
OH8MIZ	VOIMASSA	
OH8MJ	VOIMASSA	
OH8MK	VOIMASSA	
OH8MKU	VOIMASSA	
OH8MNM	VOIMASSA	
OH8MNT	VOIMASSA	
OH8MOX	VOIMASSA	
OH8MPK	VOIMASSA	
OH8MPP	VOIMASSA	
OH8MPS	VOIMASSA	
OH8MR	VOIMASSA	
OH8MSG	VOIMASSA	
OH8MSI	VOIMASSA	
OH8MTM	VOIMASSA	
OH8MUP	VOIMASSA	
OH8MV	VOIMASSA	
OH8MW	VOIMASSA	
OH8MWD	VOIMASSA	
OH8MXH	VOIMASSA	
OH8MXJ	VOIMASSA	
OH8MXL	VOIMASSA	
OH8MZ	VOIMASSA	
OH8MZQ	VOIMASSA	
OH8NAC	VOIMASSA	
OH8NAE	VOIMASSA	
OH8NAX	VOIMASSA	
OH8NC	VOIMASSA	
OH8NE	VOIMASSA	
OH8NEL	VOIMASSA	
OH8NET	VOIMASSA	
OH8NGH	VOIMASSA	
OH8NHQ	VOIMASSA	
OH8NHV	VOIMASSA	
OH8NI	VOIMASSA	
OH8NJ	VOIMASSA	
OH8NK	VOIMASSA	
OH8NKW	VOIMASSA	
OH8NLR	VOIMASSA	
OH8NNG	VOIMASSA	
OH8NQB	VOIMASSA	
OH8NR	VOIMASSA	
OH8NS	VOIMASSA	
OH8NUP	VOIMASSA	
OH8NV	VOIMASSA	
OH8NW	VOIMASSA	
OH8NXE	VOIMASSA	
OH8NYV	VOIMASSA	
OH8OJ	VOIMASSA	
OH8OK	VOIMASSA	
OH8ON	KARENSSI	
OH8OO	VOIMASSA	
OH8OR	VOIMASSA	
OH8OS	VOIMASSA	
OH8PB	VOIMASSA	
OH8PF	VOIMASSA	
OH8PI	VOIMASSA	
OH8PP	VOIMASSA	
OH8PW	VOIMASSA	
OH8QC	VOIMASSA	
OH8QD	VOIMASSA	
OH8QG	VOIMASSA	
OH8R	VOIMASSA	
OH8RAA	VOIMASSA	
OH8RAC	VOIMASSA	
OH8RAK	VOIMASSA	
OH8RAO	VOIMASSA	
OH8RAU	VOIMASSA	
OH8RDA	VOIMASSA	
OH8RDT	VOIMASSA	
OH8RDU	VOIMASSA	
OH8RDW	VOIMASSA	
OH8RK	VOIMASSA	
OH8RMD	VOIMASSA	
OH8RO	VOIMASSA	
OH8ROCK	KARENSSI	
OH8RP	VOIMASSA	
OH8RQ	VOIMASSA	
OH8RS	VOIMASSA	
OH8RUA	VOIMASSA	
OH8RUB	VOIMASSA	
OH8RUD	VOIMASSA	
OH8RUU	VOIMASSA	
OH8RV	KARENSSI	
OH8RX	VOIMASSA	
OH8SA	VOIMASSA	
OH8SE	VOIMASSA	
OH8SH	VOIMASSA	
OH8SK	VOIMASSA	
OH8SM	VOIMASSA	
OH8SP	VOIMASSA	
OH8SR	VOIMASSA	
OH8SSAB	VOIMASSA	
OH8STN	VOIMASSA	
OH8SU	VOIMASSA	
OH8SUF	VOIMASSA	
OH8T	VOIMASSA	
OH8TA	VOIMASSA	
OH8TG	VOIMASSA	
OH8TH	VOIMASSA	
OH8TK	VOIMASSA	
OH8TM	VOIMASSA	
OH8TP	VOIMASSA	
OH8TT	VOIMASSA	
OH8TTE	VOIMASSA	
OH8TU	VOIMASSA	
OH8TV	VOIMASSA	
OH8TX	VOIMASSA	
OH8UA	VOIMASSA	
OH8UAL	VOIMASSA	
OH8UBJ	VOIMASSA	
OH8UBQ	VOIMASSA	
OH8UCB	VOIMASSA	
OH8UCD	VOIMASSA	
OH8UCE	VOIMASSA	
OH8UE	VOIMASSA	
OH8UG	VOIMASSA	
OH8UI	VOIMASSA	
OH8UJ	VOIMASSA	
OH8UL	VOIMASSA	
OH8UQ	VOIMASSA	
OH8US	VOIMASSA	
OH8UV	VOIMASSA	
OH8W	VOIMASSA	
OH8VA	VOIMASSA	
OH8WA	VOIMASSA	
OH8VE	VOIMASSA	
OH8VF	VOIMASSA	
OH8VJ	VOIMASSA	
OH8WM	VOIMASSA	
OH8VP	VOIMASSA	
OH8VQ	VOIMASSA	
OH8WR	VOIMASSA	
OH8VS	VOIMASSA	
OH8WS	VOIMASSA	
OH8VT	VOIMASSA	
OH8VU	VOIMASSA	
OH8WW	VOIMASSA	
OH8WZ	VOIMASSA	
OH8X	VOIMASSA	
OH8XAT	VOIMASSA	
OH8XX	KARENSSI	
OH8YJK	VOIMASSA	
OH8Z	VOIMASSA	
OH8ZP	VOIMASSA	
OH8ZS	VOIMASSA	
OH8ZZ	VOIMASSA	
OH960AA	VOIMASSA	
OH9A	VOIMASSA	
OH9AA	VOIMASSA	
OH9AB	VOIMASSA	
OH9ABZ	VOIMASSA	
OH9AR	VOIMASSA	
OH9AZR	VOIMASSA	
OH9AZS	VOIMASSA	
OH9AZT	VOIMASSA	
OH9BCM	VOIMASSA	
OH9BDE	VOIMASSA	
OH9BDN	VOIMASSA	
OH9BGE	VOIMASSA	
OH9BKW	VOIMASSA	
OH9BMP	VOIMASSA	
OH9BOC	VOIMASSA	
OH9BS	VOIMASSA	
OH9CCK	VOIMASSA	
OH9CGC	VOIMASSA	
OH9CGD	VOIMASSA	
OH9DS	VOIMASSA	
OH9DU	VOIMASSA	
OH9DX	VOIMASSA	
OH9EEO	VOIMASSA	
OH9EGH	VOIMASSA	
OH9EKT	VOIMASSA	
OH9ELA	VOIMASSA	
OH9EN	VOIMASSA	
OH9ENA	VOIMASSA	
OH9ENX	VOIMASSA	
OH9EVC	VOIMASSA	
OH9EZJ	VOIMASSA	
OH9EZP	VOIMASSA	
OH9FCC	VOIMASSA	
OH9FF	VOIMASSA	
OH9FIQ	VOIMASSA	
OH9FIV	VOIMASSA	
OH9FKJ	VOIMASSA	
OH9FKL	VOIMASSA	
OH9FNQ	VOIMASSA	
OH9FOXI	VOIMASSA	
OH9FSX	VOIMASSA	
OH9FTD	VOIMASSA	
OH9FTW	VOIMASSA	
OH9FU	VOIMASSA	
OH9FUA	VOIMASSA	
OH9FZI	VOIMASSA	
OH9FZU	VOIMASSA	
OH9GCA	VOIMASSA	
OH9GCB	VOIMASSA	
OH9GCO	VOIMASSA	
OH9GDA	VOIMASSA	
OH9GDB	VOIMASSA	
OH9GDT	VOIMASSA	
OH9GGG	VOIMASSA	
OH9GGP	VOIMASSA	
OH9GGY	VOIMASSA	
OH9GIA	VOIMASSA	
OH9GIT	VOIMASSA	
OH9GOB	VOIMASSA	
OH9GPZ	VOIMASSA	
OH9GSZ	VOIMASSA	
OH9GUI	VOIMASSA	
OH9HCW	VOIMASSA	
OH9HDC	VOIMASSA	
OH9HDH	VOIMASSA	
OH9HEB	VOIMASSA	
OH9HEU	VOIMASSA	
OH9HFI	VOIMASSA	
OH9HPE	VOIMASSA	
OH9HR	VOIMASSA	
OH9HYX	VOIMASSA	
OH9JB	VOIMASSA	
OH9JGC	VOIMASSA	
OH9JGH	VOIMASSA	
OH9JGK	VOIMASSA	
OH9JGM	VOIMASSA	
OH9JJY	VOIMASSA	
OH9JLX	VOIMASSA	
OH9JML	VOIMASSA	
OH9JSN	VOIMASSA	
OH9JSO	VOIMASSA	
OH9JTA	VOIMASSA	
OH9JTG	VOIMASSA	
OH9JWT	VOIMASSA	
OH9K	VOIMASSA	
OH9KA	VOIMASSA	
OH9KBB	VOIMASSA	
OH9KC	VOIMASSA	
OH9KDE	VOIMASSA	
OH9KF	VOIMASSA	
OH9KHC	VOIMASSA	
OH9KKH	VOIMASSA	
OH9KL	VOIMASSA	
OH9KM	VOIMASSA	
OH9KMN	VOIMASSA	
OH9KMO	VOIMASSA	
OH9KQI	VOIMASSA	
OH9KQO	VOIMASSA	
OH9KR	VOIMASSA	
OH9KW	VOIMASSA	
OH9LA	VOIMASSA	
OH9LC	VOIMASSA	
OH9LEVI	VOIMASSA	
OH9LEY	VOIMASSA	
OH9LNA	VOIMASSA	
OH9LVH	VOIMASSA	
OH9LVY	VOIMASSA	
OH9M	VOIMASSA	
OH9MBS	VOIMASSA	
OH9MCL	VOIMASSA	
OH9MDV	VOIMASSA	
OH9MJP	VOIMASSA	
OH9MM	VOIMASSA	
OH9MMN	VOIMASSA	
OH9MMV	VOIMASSA	
OH9MP	VOIMASSA	
OH9MSB	VOIMASSA	
OH9MW	VOIMASSA	
OH9MWB	VOIMASSA	
OH9MVN	VOIMASSA	
OH9MVX	VOIMASSA	
OH9MXA	VOIMASSA	
OH9MXC	VOIMASSA	
OH9MXE	VOIMASSA	
OH9MZC	VOIMASSA	
OH9N	VOIMASSA	
OH9NB	VOIMASSA	
OH9NDD	VOIMASSA	
OH9NDG	VOIMASSA	
OH9NDL	VOIMASSA	
OH9NH	KARENSSI	
OH9NJ	KARENSSI	
OH9NLG	VOIMASSA	
OH9NNU	VOIMASSA	
OH9NON	VOIMASSA	
OH9NSY	VOIMASSA	
OH9NTR	VOIMASSA	
OH9NYW	VOIMASSA	
OH9O	KARENSSI	
OH9OD	VOIMASSA	
OH9OP	KARENSSI	
OH9OU	VOIMASSA	
OH9PE	VOIMASSA	
OH9PK	VOIMASSA	
OH9PN	VOIMASSA	
OH9PO	VOIMASSA	
OH9QB	VOIMASSA	
OH9QR	VOIMASSA	
OH9QV	VOIMASSA	
OH9RAB	VOIMASSA	
OH9RAR	VOIMASSA	
OH9RAT	VOIMASSA	
OH9RDA	VOIMASSA	
OH9RDB	VOIMASSA	
OH9RDC	VOIMASSA	
OH9RDD	VOIMASSA	
OH9RE	VOIMASSA	
OH9RHF	VOIMASSA	
OH9RJ	VOIMASSA	
OH9RK	VOIMASSA	
OH9RP	VOIMASSA	
OH9RR	VOIMASSA	
OH9RUR	VOIMASSA	
OH9RUT	VOIMASSA	
OH9S	VOIMASSA	
OH9SC	VOIMASSA	
OH9SCL	VOIMASSA	
OH9SI	VOIMASSA	
OH9SIX	VOIMASSA	
OH9SM	VOIMASSA	
OH9SQ	VOIMASSA	
OH9SR	VOIMASSA	
OH9SS	VOIMASSA	
OH9SUF	VOIMASSA	
OH9TEN	VOIMASSA	
OH9TH	VOIMASSA	
OH9TJ	VOIMASSA	
OH9TO	VOIMASSA	
OH9TP	VOIMASSA	
OH9TT	KARENSSI	
OH9UA	VOIMASSA	
OH9UCG	VOIMASSA	
OH9UFO	VOIMASSA	
OH9UHF	VOIMASSA	
OH9UI	VOIMASSA	
OH9UN	VOIMASSA	
OH9UV	VOIMASSA	
OH9UW	VOIMASSA	
OH9UX	VOIMASSA	
OH9W	VOIMASSA	
OH9WA	VOIMASSA	
OH9VB	VOIMASSA	
OH9VC	VOIMASSA	
OH9VD	VOIMASSA	
OH9VH	VOIMASSA	
OH9WH	VOIMASSA	
OH9VHF	VOIMASSA	
OH9VJ	VOIMASSA	
OH9VL	VOIMASSA	
OH9VM	VOIMASSA	
OH9VP	VOIMASSA	
OH9WR	VOIMASSA	
OH9X	VOIMASSA	
OH9XMAS	VOIMASSA	
OH9XX	VOIMASSA	
OH9YM	VOIMASSA	
OI1AX	VOIMASSA	
OI1AXA	VOIMASSA	
OI1AY	VOIMASSA	
OI2HJ	VOIMASSA	
OI2RP	VOIMASSA	
OI3AI	VOIMASSA	
OI3AX	VOIMASSA	
OI3AY	VOIMASSA	
OI3MPK	VOIMASSA	
OI3PHV	VOIMASSA	
OI3RDV	VOIMASSA	
OI3SVM	VOIMASSA	
OI3V	VOIMASSA	
OI3W	VOIMASSA	
OI4EW	VOIMASSA	
OI4JM	VOIMASSA	
OI4NV	VOIMASSA	
OI4PM	VOIMASSA	
OI5ACF	VOIMASSA	
OI5ASA	VOIMASSA	
OI5AY	VOIMASSA	
OI5AZ	VOIMASSA	
OI5PRM	VOIMASSA	
OI5R	VOIMASSA	
OI6AIR	VOIMASSA	
OI6C	VOIMASSA	
OI6S	VOIMASSA	
OI6SP	VOIMASSA	
OI6VKL	VOIMASSA	
OI6X	VOIMASSA	
OI7AX	VOIMASSA	
OI7TK	VOIMASSA	
OI8AY	VOIMASSA	
OI8VK	VOIMASSA	
OI9R	VOIMASSA	
OJ0A	VOIMASSA	
OJ0AM	VOIMASSA	
OJ0AW	VOIMASSA	
OJ0B	VOIMASSA	
OJ0BH	VOIMASSA	
OJ0C	VOIMASSA	
OJ0D	VOIMASSA	
OJ0DX	VOIMASSA	
OJ0JR	VOIMASSA	
OJ0KA	VOIMASSA	
OJ0KV	VOIMASSA	
OJ0LA	VOIMASSA	
OJ0M	VOIMASSA	
OJ0MI	VOIMASSA	
OJ0MR	VOIMASSA	
OJ0O	VOIMASSA	
OJ0RJ	VOIMASSA	
OJ0S	VOIMASSA	
OJ0WS	VOIMASSA	
OJ0YC	VOIMASSA	
OJ0Z	VOIMASSA	
OJ1ABOA	VOIMASSA	
OJ9A	VOIMASSA	
